Country,Region,Edition,Electoral Process,Political Pluralism and Participation,Functioning of Govrnment,Political Rights Total,Freedom of Expression and Belief,Associaltional and Organizational Rights,Rule of Law,Personal Autonomy and Individual Rights,Civil Liberties Total,Total
Afghanistan,Asia,2024,0,0,1,1,0,3,0,2,5,6
Albania,Europe,2024,9,12,7,28,13,8,10,9,40,68
Algeria,Africa,2024,3,4,3,10,6,3,6,7,22,32
Andorra,Europe,2024,12,15,11,38,14,11,15,15,55,93
Angola,Africa,2024,3,5,2,10,7,3,5,3,18,28
Antigua and Barbuda,Americas,2024,12,13,8,33,15,10,14,13,52,85
Argentina,Americas,2024,11,16,8,35,15,11,10,14,50,85
Armenia,Eurasia,2024,7,10,6,23,9,8,5,9,31,54
Australia,Asia,2024,12,15,11,38,15,12,15,15,57,95
Austria,Europe,2024,12,15,10,37,14,12,15,15,56,93
Azerbaijan,Eurasia,2024,0,4,0,0,2,1,0,4,7,7
Bahamas,Americas,2024,12,16,10,38,15,12,13,13,53,91
Bahrain,Middle East,2024,2,2,2,2,2,1,1,6,10,12
Bangladesh,Asia,2024,4,7,4,15,6,5,5,9,25,40
Barbados,Americas,2024,12,15,10,37,16,12,14,15,57,94
Belarus,Eurasia,2024,0,1,1,2,1,0,0,5,6,8
Belgium,Europe,2024,12,16,11,39,15,12,15,15,57,96
Belize,Americas,2024,12,14,8,34,16,11,13,13,53,87
Benin,Africa,2024,4,10,5,19,14,9,9,10,42,61
Bhutan,Asia,2024,10,14,8,30,10,5,9,9,33,63
Bolivia,Americas,2024,10,10,7,27,14,9,6,10,39,66
Bosnia and Herzegovina,Europe,2024,5,8,4,17,10,7,7,10,34,51
Botswana,Africa,2024,10,10,8,28,12,10,11,11,44,72
Brazil,Americas,2024,10,13,7,30,14,9,8,11,42,72
Brunei,Asia,2024,0,3,4,7,6,3,5,7,21,28
Bulgaria,Europe,2024,10,14,8,32,13,11,10,12,46,78
Burkina Faso,Africa,2024,0,2,1,3,7,7,4,6,24,27
Burundi,Africa,2024,1,3,0,4,4,1,1,4,10,14
Cabo Verde,Africa,2024,12,16,10,38,16,11,14,13,54,92
Cambodia,Asia,2024,0,2,2,4,7,3,3,6,19,23
Cameroon,Africa,2024,1,3,2,6,4,2,0,3,9,15
Canada,Americas,2024,12,16,11,39,15,12,15,16,58,97
Central African Republic,Africa,2024,1,2,0,1,3,1,0,0,4,5
Chad,Africa,2024,0,1,0,1,6,4,1,3,14,15
Chile,Americas,2024,12,15,11,38,16,12,13,15,56,94
China,Asia,2024,0,3,1,-2,1,2,2,6,11,9
Colombia,Americas,2024,10,13,8,31,13,6,9,11,39,70
Comoros,Africa,2024,5,7,4,16,8,6,6,6,26,42
Congo (Brazzaville),Africa,2024,0,2,0,2,6,2,1,6,15,17
Congo (Kinshasa),Africa,2024,1,2,1,4,7,3,1,4,15,19
Costa Rica,Americas,2024,12,15,11,38,16,11,13,13,53,91
"Cote d'Ivoire",Africa,2024,6,9,4,19,10,7,6,7,30,49
Croatia,Europe,2024,12,14,8,34,13,12,11,13,49,83
Cuba,Americas,2024,0,0,1,1,4,0,1,6,11,12
Cyprus,Europe,2024,12,15,11,38,15,11,15,13,54,92
Czech Republic,Europe,2024,12,15,9,36,16,12,15,15,58,94
Denmark,Europe,2024,12,16,12,40,16,12,14,15,57,97
Djibouti,Africa,2024,2,3,0,5,6,3,4,6,19,24
Dominica,Americas,2024,11,16,10,37,15,11,15,15,56,93
Dominican Republic,Americas,2024,9,11,7,27,14,10,8,9,41,68
Ecuador,Americas,2024,11,12,6,29,12,9,7,10,38,67
Egypt,Africa,2024,2,2,2,6,3,1,2,6,12,18
El Salvador,Americas,2024,9,10,2,21,11,7,4,10,32,53
Equatorial Guinea,Africa,2024,0,0,0,0,2,0,0,3,5,5
Eritrea,Africa,2024,0,0,1,1,1,0,0,1,2,3
Estonia,Europe,2024,12,15,11,38,16,12,14,15,57,95
Eswatini,Africa,2024,0,1,0,1,5,2,4,5,16,17
Ethiopia,Africa,2024,4,6,4,10,4,2,1,3,10,20
Fiji,Asia,2024,8,11,8,27,14,8,7,10,39,66
Finland,Europe,2024,12,16,12,40,16,12,16,16,60,100
France,Europe,2024,12,15,11,38,14,10,13,14,51,89
Gabon,Africa,2024,0,2,0,2,7,3,3,5,18,20
Georgia,Eurasia,2024,7,8,7,22,9,7,8,12,36,58
Germany,Europe,2024,12,15,12,39,14,11,14,15,54,93
Ghana,Africa,2024,12,13,10,35,14,10,10,11,45,80
Greece,Europe,2024,12,15,8,35,13,12,11,14,50,85
Grenada,Americas,2024,11,16,10,37,15,11,13,13,52,89
Guatemala,Americas,2024,6,8,3,17,10,6,5,8,29,46
Guinea,Africa,2024,0,5,2,7,9,4,4,6,23,30
Guinea-Bissau,Africa,2024,7,8,2,17,10,6,5,5,26,43
Guyana,Americas,2024,9,13,8,30,15,11,8,9,43,73
Haiti,Americas,2024,3,5,3,11,8,4,3,4,19,30
Honduras,Americas,2024,8,9,5,22,9,5,4,8,26,48
Hungary,Europe,2024,7,11,6,24,10,8,10,13,41,65
Iceland,Europe,2024,12,15,10,37,15,12,15,15,57,94
India,Asia,2024,12,12,9,33,9,7,8,9,33,66
Indonesia,Asia,2024,11,12,6,29,9,6,5,8,28,57
Iran,Middle East,2024,2,2,0,4,0,1,2,4,7,11
Iraq,Middle East,2024,8,8,2,16,4,5,1,4,14,30
Ireland,Europe,2024,12,16,11,39,16,12,14,16,58,97
Israel,Middle East,2024,12,13,9,34,12,9,8,11,40,74
Italy,Europe,2024,12,14,10,36,15,12,13,14,54,90
Jamaica,Americas,2024,11,13,9,33,15,11,10,11,47,80
Japan,Asia,2024,12,16,12,40,15,12,15,14,56,96
Jordan,Middle East,2024,2,6,3,11,6,2,7,7,22,33
Kazakhstan,Eurasia,2024,1,3,1,5,4,2,4,8,18,23
Kenya,Africa,2024,8,9,5,22,10,7,6,7,30,52
Kiribati,Asia,2024,12,15,10,37,16,12,12,13,53,90
Kosovo,Europe,2024,9,13,6,28,10,8,6,8,32,60
Kuwait,Middle East,2024,3,7,4,14,6,5,7,6,24,38
Kyrgyzstan,Eurasia,2024,2,4,0,4,10,4,2,7,23,27
Laos,Asia,2024,0,0,2,2,3,0,2,6,11,13
Latvia,Europe,2024,12,15,10,37,14,12,11,14,51,88
Lebanon,Middle East,2024,4,8,1,13,10,8,5,6,29,42
Lesotho,Africa,2024,11,13,6,30,12,7,8,9,36,66
Liberia,Africa,2024,11,13,6,30,11,8,6,9,34,64
Libya,Africa,2024,0,1,0,1,3,3,0,2,8,9
Liechtenstein,Europe,2024,10,13,10,33,16,12,14,15,57,90
Lithuania,Europe,2024,12,16,10,38,15,11,11,14,51,89
Luxembourg,Europe,2024,12,16,10,38,16,12,15,16,59,97
Madagascar,Africa,2024,8,9,7,24,11,8,7,8,34,58
Malawi,Africa,2024,9,12,8,29,13,8,9,7,37,66
Malaysia,Asia,2024,6,10,6,22,8,6,8,9,31,53
Maldives,Asia,2024,8,8,5,21,3,6,7,7,23,44
Mali,Africa,2024,1,3,2,6,7,5,4,4,20,26
Malta,Europe,2024,12,14,9,35,14,12,12,14,52,87
Marshall Islands,Asia,2024,12,16,10,38,16,11,15,13,55,93
Mauritania,Africa,2024,6,5,4,15,9,5,5,5,24,39
Mauritius,Africa,2024,11,14,10,35,14,11,13,12,50,85
Mexico,Americas,2024,9,13,5,27,12,7,5,9,33,60
Micronesia,Asia,2024,12,15,10,37,16,11,15,13,55,92
Moldova,Eurasia,2024,9,12,5,26,12,8,6,9,35,61
Monaco,Europe,2024,8,9,8,25,16,12,14,15,57,82
Mongolia,Asia,2024,11,16,9,36,14,11,11,12,48,84
Montenegro,Europe,2024,8,12,7,27,12,9,10,11,42,69
Morocco,Africa,2024,5,5,3,13,7,5,5,7,24,37
Mozambique,Africa,2024,3,7,4,14,9,5,7,9,30,44
Myanmar,Asia,2024,0,7,1,0,3,2,0,3,8,8
Namibia,Africa,2024,11,12,8,31,14,11,11,10,46,77
Nauru,Asia,2024,12,14,8,34,13,9,9,12,43,77
Nepal,Asia,2024,11,11,6,28,10,8,8,8,34,62
Netherlands,Europe,2024,12,16,11,39,16,12,15,15,58,97
New Zealand,Asia,2024,12,16,12,40,16,12,15,16,59,99
Nicaragua,Americas,2024,0,2,2,4,2,2,2,6,12,16
Niger,Africa,2024,0,4,2,6,9,6,6,6,27,33
Nigeria,Africa,2024,6,9,5,20,9,7,4,4,24,44
North Korea,Asia,2024,0,0,0,0,0,0,0,3,3,3
North Macedonia,Europe,2024,9,12,7,28,12,8,9,10,39,67
Norway,Europe,2024,12,16,11,39,16,12,15,16,59,98
Oman,Middle East,2024,2,2,2,6,5,4,4,5,18,24
Pakistan,Asia,2024,5,5,4,14,6,6,3,6,21,35
Palau,Asia,2024,12,15,10,37,16,11,15,13,55,92
Panama,Americas,2024,12,15,8,35,15,11,10,12,48,83
Papua New Guinea,Asia,2024,6,13,3,22,14,10,7,8,39,61
Paraguay,Americas,2024,9,11,6,26,12,8,7,10,37,63
Peru,Americas,2024,10,12,5,27,15,6,8,10,39,66
Philippines,Asia,2024,9,10,6,25,11,7,5,10,33,58
Poland,Europe,2024,9,16,8,33,13,10,10,14,47,80
Portugal,Europe,2024,12,16,11,39,16,12,14,15,57,96
Qatar,Middle East,2024,2,2,3,7,7,2,5,4,18,25
Romania,Europe,2024,12,14,9,35,13,11,12,12,48,83
Russia,Eurasia,2024,0,3,1,4,1,2,2,4,9,13
Rwanda,Africa,2024,2,2,4,8,3,2,3,7,15,23
Samoa,Asia,2024,9,14,9,32,14,12,14,12,52,84
San Marino,Europe,2024,12,15,12,39,15,12,15,16,58,97
Sao Tome and Principe,Africa,2024,11,15,9,35,15,11,12,11,49,84
Saudi Arabia,Middle East,2024,0,0,1,1,2,0,3,2,7,8
Senegal,Africa,2024,9,11,8,28,13,7,8,11,39,67
Serbia,Europe,2024,5,9,4,18,11,7,9,12,39,57
Seychelles,Africa,2024,12,13,9,34,14,9,11,11,45,79
Sierra Leone,Africa,2024,7,11,6,24,12,5,9,10,36,60
Singapore,Asia,2024,4,8,7,19,7,3,7,12,29,48
Slovakia,Europe,2024,12,15,10,37,15,12,12,14,53,90
Slovenia,Europe,2024,12,16,11,39,15,12,15,15,57,96
Solomon Islands,Asia,2024,8,13,7,28,14,10,11,12,47,75
Somalia,Africa,2024,0,2,0,2,3,3,0,0,6,8
South Africa,Africa,2024,12,13,8,33,15,12,9,10,46,79
South Korea,Asia,2024,11,13,9,33,14,11,12,13,50,83
South Sudan,Africa,2024,0,5,0,-3,2,2,0,0,4,1
Spain,Europe,2024,12,16,9,37,14,11,13,15,53,90
Sri Lanka,Asia,2024,9,10,5,22,9,8,7,8,32,54
St. Kitts and Nevis,Americas,2024,10,15,10,35,16,12,13,13,54,89
St. Lucia,Americas,2024,11,16,11,38,15,12,13,14,54,92
St. Vincent and the Grenadines,Americas,2024,11,15,10,36,15,12,13,14,54,90
Sudan,Africa,2024,0,3,0,-3,5,1,0,3,9,6
Suriname,Americas,2024,11,14,9,34,15,11,9,10,45,79
Sweden,Europe,2024,12,16,12,40,16,12,15,16,59,99
Switzerland,Europe,2024,12,15,12,39,15,12,15,15,57,96
Syria,Middle East,2024,0,3,0,-3,3,0,0,1,4,1
Taiwan,Asia,2024,12,15,11,38,16,11,15,14,56,94
Tajikistan,Eurasia,2024,0,0,0,0,0,1,0,4,5,5
Tanzania,Africa,2024,3,5,4,12,7,5,4,8,24,36
Thailand,Asia,2024,3,6,3,12,6,3,5,10,24,36
The Gambia,Africa,2024,8,9,5,22,9,6,7,6,28,50
Timor-Leste,Asia,2024,11,14,8,33,14,8,8,9,39,72
Togo,Africa,2024,4,6,5,15,9,5,6,7,27,42
Tonga,Asia,2024,9,14,8,31,14,11,12,13,50,81
Trinidad and Tobago,Americas,2024,11,13,9,33,16,11,9,13,49,82
Tunisia,Africa,2024,6,7,3,16,11,7,7,10,35,51
Turkey,Europe,2024,5,8,4,17,5,3,3,5,16,33
Turkmenistan,Eurasia,2024,0,0,0,0,0,0,0,2,2,2
Tuvalu,Asia,2024,12,15,10,37,16,12,15,13,56,93
Uganda,Africa,2024,3,4,3,10,9,4,4,7,24,34
Ukraine,Eurasia,2024,9,12,4,21,9,7,4,8,28,49
United Arab Emirates,Middle East,2024,1,2,2,5,4,2,3,4,13,18
United Kingdom,Europe,2024,12,16,10,38,14,11,13,15,53,91
United States,Americas,2024,10,14,9,33,14,11,11,14,50,83
Uruguay,Americas,2024,12,16,12,40,15,12,14,15,56,96
Uzbekistan,Eurasia,2024,1,0,1,2,4,1,1,4,10,12
Vanuatu,Asia,2024,10,15,7,32,15,11,13,11,50,82
Venezuela,Americas,2024,0,1,0,1,6,2,1,5,14,15
Vietnam,Asia,2024,0,1,3,4,3,1,4,7,15,19
Yemen,Middle East,2024,0,1,0,1,2,3,2,2,9,10
Zambia,Africa,2024,6,11,6,23,8,7,8,8,31,54
Zimbabwe,Africa,2024,3,4,3,10,7,3,2,5,17,27
Afghanistan,Asia,2023,0,0,1,1,2,3,0,2,7,8
Albania,Europe,2023,9,12,7,28,13,8,9,9,39,67
Algeria,Africa,2023,3,4,3,10,6,3,6,7,22,32
Andorra,Europe,2023,12,15,11,38,14,11,15,15,55,93
Angola,Africa,2023,3,5,2,10,7,3,5,3,18,28
Antigua and Barbuda,Americas,2023,12,13,8,33,15,10,14,13,52,85
Argentina,Americas,2023,11,16,8,35,15,11,10,14,50,85
Armenia,Eurasia,2023,7,10,6,23,9,8,5,9,31,54
Australia,Asia,2023,12,15,11,38,15,12,15,15,57,95
Austria,Europe,2023,12,15,10,37,14,12,15,15,56,93
Azerbaijan,Eurasia,2023,0,2,0,2,2,1,0,4,7,9
Bahamas,Americas,2023,12,16,10,38,15,12,13,13,53,91
Bahrain,Middle East,2023,2,2,2,2,2,1,1,6,10,12
Bangladesh,Asia,2023,4,7,4,15,6,5,5,9,25,40
Barbados,Americas,2023,12,15,10,37,16,12,14,15,57,94
Belarus,Eurasia,2023,0,1,1,2,1,0,0,5,6,8
Belgium,Europe,2023,12,16,11,39,15,12,15,15,57,96
Belize,Americas,2023,12,14,8,34,16,11,13,13,53,87
Benin,Africa,2023,3,9,5,17,14,8,10,10,42,59
Bhutan,Asia,2023,10,13,8,29,9,5,9,9,32,61
Bolivia,Americas,2023,10,10,7,27,14,9,6,10,39,66
Bosnia and Herzegovina,Europe,2023,5,9,4,18,10,7,7,10,34,52
Botswana,Africa,2023,10,10,8,28,12,10,11,11,44,72
Brazil,Americas,2023,10,13,7,30,13,9,8,12,42,72
Brunei,Asia,2023,0,3,4,7,6,3,5,7,21,28
Bulgaria,Europe,2023,11,14,8,33,13,11,10,12,46,79
Burkina Faso,Africa,2023,0,2,1,3,10,7,4,6,27,30
Burundi,Africa,2023,1,3,0,4,4,1,1,4,10,14
Cabo Verde,Africa,2023,12,16,10,38,16,11,14,13,54,92
Cambodia,Asia,2023,1,2,2,5,7,3,3,6,19,24
Cameroon,Africa,2023,1,3,2,6,4,2,0,3,9,15
Canada,Americas,2023,12,16,12,40,15,12,15,16,58,98
Central African Republic,Africa,2023,2,3,0,3,3,1,0,0,4,7
Chad,Africa,2023,0,1,0,1,6,4,1,3,14,15
Chile,Americas,2023,12,15,11,38,16,12,13,15,56,94
China,Asia,2023,0,3,1,-2,1,2,2,6,11,9
Colombia,Americas,2023,10,13,8,31,13,6,9,11,39,70
Comoros,Africa,2023,5,7,4,16,8,6,6,6,26,42
Congo (Brazzaville),Africa,2023,0,2,0,2,6,2,1,6,15,17
Congo (Kinshasa),Africa,2023,1,2,1,4,7,3,1,4,15,19
Costa Rica,Americas,2023,12,15,11,38,16,11,13,13,53,91
"Cote d'Ivoire",Africa,2023,6,9,4,19,10,7,6,7,30,49
Croatia,Europe,2023,12,14,9,35,13,12,11,13,49,84
Cuba,Americas,2023,0,0,1,1,4,0,1,6,11,12
Cyprus,Europe,2023,12,15,11,38,15,11,15,13,54,92
Czech Republic,Europe,2023,12,15,9,36,15,12,14,15,56,92
Denmark,Europe,2023,12,16,12,40,16,12,14,15,57,97
Djibouti,Africa,2023,2,3,0,5,6,3,4,6,19,24
Dominica,Americas,2023,11,16,10,37,15,11,15,15,56,93
Dominican Republic,Americas,2023,9,11,7,27,14,10,8,9,41,68
Ecuador,Americas,2023,11,13,6,30,13,9,8,10,40,70
Egypt,Africa,2023,2,2,2,6,3,1,2,6,12,18
El Salvador,Americas,2023,10,12,3,25,11,7,4,9,31,56
Equatorial Guinea,Africa,2023,0,0,0,0,2,0,0,3,5,5
Eritrea,Africa,2023,0,0,1,1,1,0,0,1,2,3
Estonia,Europe,2023,12,15,11,38,16,12,14,14,56,94
Eswatini,Africa,2023,0,1,0,1,5,2,4,5,16,17
Ethiopia,Africa,2023,4,6,4,10,4,3,1,3,11,21
Fiji,Asia,2023,7,10,7,24,11,7,7,10,35,59
Finland,Europe,2023,12,16,12,40,16,12,16,16,60,100
France,Europe,2023,12,15,11,38,14,10,13,14,51,89
Gabon,Africa,2023,0,2,0,2,7,3,3,5,18,20
Georgia,Eurasia,2023,7,8,7,22,9,7,8,12,36,58
Germany,Europe,2023,12,15,12,39,14,12,14,15,55,94
Ghana,Africa,2023,12,13,10,35,14,10,10,11,45,80
Greece,Europe,2023,12,15,8,35,14,12,11,14,51,86
Grenada,Americas,2023,11,16,10,37,15,11,13,13,52,89
Guatemala,Americas,2023,7,10,3,20,10,6,5,8,29,49
Guinea,Africa,2023,0,5,2,7,9,4,4,6,23,30
Guinea-Bissau,Africa,2023,7,8,2,17,10,6,5,5,26,43
Guyana,Americas,2023,9,13,8,30,15,11,8,9,43,73
Haiti,Americas,2023,3,5,3,11,8,4,4,4,20,31
Honduras,Americas,2023,8,9,5,22,9,5,4,8,26,48
Hungary,Europe,2023,7,11,6,24,10,9,10,13,42,66
Iceland,Europe,2023,12,15,10,37,15,12,15,15,57,94
India,Asia,2023,12,12,9,33,9,7,8,9,33,66
Indonesia,Asia,2023,11,13,6,30,9,6,5,8,28,58
Iran,Middle East,2023,2,2,0,4,1,1,2,4,8,12
Iraq,Middle East,2023,8,8,2,16,4,4,1,4,13,29
Ireland,Europe,2023,12,16,11,39,16,12,14,16,58,97
Israel,Middle East,2023,12,13,9,34,12,9,11,11,43,77
Italy,Europe,2023,12,14,10,36,15,12,13,14,54,90
Jamaica,Americas,2023,12,13,9,34,15,11,9,11,46,80
Japan,Asia,2023,12,16,12,40,15,12,15,14,56,96
Jordan,Middle East,2023,2,6,3,11,7,1,7,7,22,33
Kazakhstan,Eurasia,2023,1,3,1,5,4,2,4,8,18,23
Kenya,Africa,2023,8,9,5,22,10,7,6,7,30,52
Kiribati,Asia,2023,12,15,10,37,16,12,13,13,54,91
Kosovo,Europe,2023,9,13,6,28,10,8,6,8,32,60
Kuwait,Middle East,2023,3,7,4,14,6,4,7,6,23,37
Kyrgyzstan,Eurasia,2023,2,4,0,4,10,4,2,7,23,27
Laos,Asia,2023,0,0,2,2,3,0,2,6,11,13
Latvia,Europe,2023,12,15,10,37,14,12,11,14,51,88
Lebanon,Middle East,2023,5,8,1,14,10,8,5,6,29,43
Lesotho,Africa,2023,11,13,6,30,12,7,8,9,36,66
Liberia,Africa,2023,8,12,7,27,11,7,6,9,33,60
Libya,Africa,2023,0,1,0,1,4,3,0,2,9,10
Liechtenstein,Europe,2023,10,13,10,33,16,12,14,15,57,90
Lithuania,Europe,2023,12,16,10,38,15,11,11,14,51,89
Luxembourg,Europe,2023,12,16,10,38,16,12,15,16,59,97
Madagascar,Africa,2023,9,11,7,27,11,8,7,8,34,61
Malawi,Africa,2023,9,12,8,29,13,8,9,7,37,66
Malaysia,Asia,2023,6,10,6,22,8,6,8,9,31,53
Maldives,Asia,2023,7,8,4,19,3,5,7,7,22,41
Mali,Africa,2023,1,5,2,8,8,5,4,4,21,29
Malta,Europe,2023,12,14,9,35,14,12,14,14,54,89
Marshall Islands,Asia,2023,12,16,10,38,16,11,15,13,55,93
Mauritania,Africa,2023,6,4,4,14,9,5,4,4,22,36
Mauritius,Africa,2023,11,14,10,35,14,11,13,12,50,85
Mexico,Americas,2023,9,13,5,27,12,7,5,9,33,60
Micronesia,Asia,2023,12,15,10,37,16,11,15,13,55,92
Moldova,Eurasia,2023,10,12,5,27,12,8,6,9,35,62
Monaco,Europe,2023,8,10,9,27,16,12,14,15,57,84
Mongolia,Asia,2023,11,16,9,36,14,11,11,12,48,84
Montenegro,Europe,2023,8,11,7,26,12,9,9,11,41,67
Morocco,Africa,2023,5,5,3,13,7,5,5,7,24,37
Mozambique,Africa,2023,3,7,4,14,9,6,7,9,31,45
Myanmar,Asia,2023,0,7,1,0,3,2,0,4,9,9
Namibia,Africa,2023,11,12,8,31,14,11,11,10,46,77
Nauru,Asia,2023,12,14,8,34,13,9,9,12,43,77
Nepal,Asia,2023,10,11,5,26,10,7,7,8,32,58
Netherlands,Europe,2023,12,16,11,39,16,12,15,15,58,97
New Zealand,Asia,2023,12,16,12,40,16,12,15,16,59,99
Nicaragua,Americas,2023,0,3,2,5,2,2,2,8,14,19
Niger,Africa,2023,8,9,6,23,10,6,6,6,28,51
Nigeria,Africa,2023,6,9,5,20,9,6,4,4,23,43
North Korea,Asia,2023,0,0,0,0,0,0,0,3,3,3
North Macedonia,Europe,2023,9,12,8,29,12,8,9,10,39,68
Norway,Europe,2023,12,16,12,40,16,12,16,16,60,100
Oman,Middle East,2023,2,2,2,6,5,4,4,5,18,24
Pakistan,Asia,2023,5,6,4,15,6,6,4,6,22,37
Palau,Asia,2023,12,15,10,37,16,11,15,13,55,92
Panama,Americas,2023,12,15,8,35,15,11,10,12,48,83
Papua New Guinea,Asia,2023,6,13,3,22,14,10,7,8,39,61
Paraguay,Americas,2023,10,12,6,28,12,8,7,10,37,65
Peru,Americas,2023,10,13,6,29,15,7,8,11,41,70
Philippines,Asia,2023,9,10,6,25,11,7,5,10,33,58
Poland,Europe,2023,10,16,8,34,13,10,10,14,47,81
Portugal,Europe,2023,12,16,11,39,16,12,14,15,57,96
Qatar,Middle East,2023,2,2,3,7,7,2,5,4,18,25
Romania,Europe,2023,12,14,9,35,13,11,12,12,48,83
Russia,Eurasia,2023,0,3,2,5,2,2,2,5,11,16
Rwanda,Africa,2023,2,2,4,8,3,2,3,7,15,23
Samoa,Asia,2023,9,13,9,31,14,12,14,12,52,83
San Marino,Europe,2023,12,15,12,39,15,12,15,16,58,97
Sao Tome and Principe,Africa,2023,11,15,9,35,15,11,12,11,49,84
Saudi Arabia,Middle East,2023,0,0,1,1,2,0,3,2,7,8
Senegal,Africa,2023,9,12,8,29,13,7,8,11,39,68
Serbia,Europe,2023,6,9,5,20,12,7,9,12,40,60
Seychelles,Africa,2023,12,13,9,34,14,9,11,11,45,79
Sierra Leone,Africa,2023,9,11,7,27,12,5,9,10,36,63
Singapore,Asia,2023,4,8,7,19,7,3,7,11,28,47
Slovakia,Europe,2023,12,15,10,37,15,12,12,14,53,90
Slovenia,Europe,2023,12,16,11,39,14,12,15,15,56,95
Solomon Islands,Asia,2023,8,14,7,29,14,10,11,12,47,76
Somalia,Africa,2023,0,2,0,2,3,3,0,0,6,8
South Africa,Africa,2023,12,13,8,33,15,12,9,10,46,79
South Korea,Asia,2023,11,13,9,33,14,11,12,13,50,83
South Sudan,Africa,2023,0,5,0,-3,2,2,0,0,4,1
Spain,Europe,2023,12,16,9,37,14,11,13,15,53,90
Sri Lanka,Asia,2023,9,11,5,23,8,8,7,8,31,54
St. Kitts and Nevis,Americas,2023,10,15,10,35,16,12,13,13,54,89
St. Lucia,Americas,2023,11,16,11,38,15,12,13,14,54,92
St. Vincent and the Grenadines,Americas,2023,11,15,10,36,15,12,14,14,55,91
Sudan,Africa,2023,0,4,0,0,5,2,0,3,10,10
Suriname,Americas,2023,11,14,9,34,15,11,9,10,45,79
Sweden,Europe,2023,12,16,12,40,16,12,16,16,60,100
Switzerland,Europe,2023,12,15,12,39,15,12,15,15,57,96
Syria,Middle East,2023,0,3,0,-3,3,0,0,1,4,1
Taiwan,Asia,2023,12,15,11,38,16,11,15,14,56,94
Tajikistan,Eurasia,2023,0,0,0,0,1,1,1,4,7,7
Tanzania,Africa,2023,3,5,4,12,7,5,4,8,24,36
Thailand,Asia,2023,1,3,2,6,6,3,5,10,24,30
The Gambia,Africa,2023,8,9,4,21,8,6,7,6,27,48
Timor-Leste,Asia,2023,11,14,8,33,14,8,8,9,39,72
Togo,Africa,2023,4,6,5,15,9,5,6,7,27,42
Tonga,Asia,2023,9,14,8,31,14,11,12,13,50,81
Trinidad and Tobago,Americas,2023,11,13,9,33,16,11,9,13,49,82
Tunisia,Africa,2023,6,10,4,20,11,7,8,10,36,56
Turkey,Europe,2023,5,8,3,16,5,3,3,5,16,32
Turkmenistan,Eurasia,2023,0,0,0,0,0,0,0,2,2,2
Tuvalu,Asia,2023,12,15,10,37,16,12,15,13,56,93
Uganda,Africa,2023,3,5,3,11,9,4,4,7,24,35
Ukraine,Eurasia,2023,9,13,4,22,9,7,4,8,28,50
United Arab Emirates,Middle East,2023,1,2,2,5,4,2,3,4,13,18
United Kingdom,Europe,2023,12,16,11,39,14,12,13,15,54,93
United States,Americas,2023,10,14,9,33,14,11,11,14,50,83
Uruguay,Americas,2023,12,16,12,40,15,12,14,15,56,96
Uzbekistan,Eurasia,2023,1,0,1,2,4,1,1,4,10,12
Vanuatu,Asia,2023,10,15,8,33,14,11,13,11,49,82
Venezuela,Americas,2023,0,1,0,1,6,2,1,5,14,15
Vietnam,Asia,2023,0,1,3,4,3,1,4,7,15,19
Yemen,Middle East,2023,0,1,0,1,2,3,1,2,8,9
Zambia,Africa,2023,6,11,6,23,8,7,8,8,31,54
Zimbabwe,Africa,2023,3,5,3,11,7,3,2,5,17,28
Afghanistan,Asia,2022,0,0,1,1,4,3,0,2,9,10
Albania,Europe,2022,9,12,7,28,13,8,9,9,39,67
Algeria,Africa,2022,3,4,3,10,6,3,6,7,22,32
Andorra,Europe,2022,12,15,11,38,14,11,15,15,55,93
Angola,Africa,2022,3,5,2,10,7,5,5,3,20,30
Antigua and Barbuda,Americas,2022,12,13,8,33,15,10,14,13,52,85
Argentina,Americas,2022,11,16,8,35,15,11,10,13,49,84
Armenia,Eurasia,2022,7,10,6,23,9,8,6,9,32,55
Australia,Asia,2022,12,15,12,39,15,12,15,14,56,95
Austria,Europe,2022,12,15,10,37,14,12,15,15,56,93
Azerbaijan,Eurasia,2022,0,2,0,2,2,1,0,4,7,9
Bahamas,Americas,2022,12,16,10,38,15,12,13,13,53,91
Bahrain,Middle East,2022,2,2,2,2,2,1,1,6,10,12
Bangladesh,Asia,2022,4,7,4,15,6,5,4,9,24,39
Barbados,Americas,2022,12,16,10,38,16,12,14,15,57,95
Belarus,Eurasia,2022,0,1,1,2,1,0,0,5,6,8
Belgium,Europe,2022,12,16,11,39,15,12,15,15,57,96
Belize,Americas,2022,12,14,8,34,16,11,13,13,53,87
Benin,Africa,2022,3,9,5,17,14,8,10,10,42,59
Bhutan,Asia,2022,10,13,8,29,9,5,9,9,32,61
Bolivia,Americas,2022,10,10,7,27,14,9,6,10,39,66
Bosnia and Herzegovina,Europe,2022,6,9,4,19,10,7,7,10,34,53
Botswana,Africa,2022,10,10,8,28,12,10,11,11,44,72
Brazil,Americas,2022,10,14,7,31,13,9,8,12,42,73
Brunei,Asia,2022,0,3,4,7,6,3,5,7,21,28
Bulgaria,Europe,2022,11,14,8,33,13,11,10,12,46,79
Burkina Faso,Africa,2022,7,10,6,23,11,7,5,7,30,53
Burundi,Africa,2022,1,3,0,4,4,1,1,4,10,14
Cabo Verde,Africa,2022,12,16,10,38,16,11,14,13,54,92
Cambodia,Asia,2022,1,2,2,5,7,3,3,6,19,24
Cameroon,Africa,2022,1,3,2,6,4,2,0,3,9,15
Canada,Americas,2022,12,16,12,40,15,12,15,16,58,98
Central African Republic,Africa,2022,2,3,0,3,3,1,0,0,4,7
Chad,Africa,2022,0,1,0,1,6,4,1,3,14,15
Chile,Americas,2022,12,15,11,38,16,12,13,15,56,94
China,Asia,2022,0,3,1,-2,1,2,2,6,11,9
Colombia,Americas,2022,10,11,8,29,12,5,9,9,35,64
Comoros,Africa,2022,5,7,4,16,8,6,6,6,26,42
Congo (Brazzaville),Africa,2022,0,2,0,2,6,2,1,6,15,17
Congo (Kinshasa),Africa,2022,1,2,1,4,7,3,1,4,15,19
Costa Rica,Americas,2022,12,15,11,38,16,11,13,13,53,91
"Cote d'Ivoire",Africa,2022,6,9,4,19,10,7,6,7,30,49
Croatia,Europe,2022,12,14,10,36,13,12,11,13,49,85
Cuba,Americas,2022,0,0,1,1,4,0,1,6,11,12
Cyprus,Europe,2022,12,15,11,38,15,11,15,14,55,93
Czech Republic,Europe,2022,12,15,9,36,14,12,14,15,55,91
Denmark,Europe,2022,12,16,12,40,16,12,14,15,57,97
Djibouti,Africa,2022,2,3,0,5,6,3,4,6,19,24
Dominica,Americas,2022,11,16,10,37,15,11,15,15,56,93
Dominican Republic,Americas,2022,9,11,7,27,14,10,8,9,41,68
Ecuador,Americas,2022,11,13,7,31,13,9,8,10,40,71
Egypt,Africa,2022,2,2,2,6,3,1,2,6,12,18
El Salvador,Americas,2022,10,12,4,26,11,8,6,8,33,59
Equatorial Guinea,Africa,2022,0,0,0,0,2,0,0,3,5,5
Eritrea,Africa,2022,0,0,1,1,1,0,0,1,2,3
Estonia,Europe,2022,12,15,11,38,16,12,14,14,56,94
Eswatini,Africa,2022,0,1,0,1,5,2,4,5,16,17
Ethiopia,Africa,2022,4,4,4,12,4,3,1,3,11,23
Fiji,Asia,2022,7,9,7,23,11,7,7,10,35,58
Finland,Europe,2022,12,16,12,40,16,12,16,16,60,100
France,Europe,2022,12,15,11,38,14,10,13,14,51,89
Gabon,Africa,2022,0,2,1,3,7,3,3,5,18,21
Georgia,Eurasia,2022,7,8,7,22,9,7,8,12,36,58
Germany,Europe,2022,12,15,12,39,14,12,14,15,55,94
Ghana,Africa,2022,12,13,10,35,14,10,10,11,45,80
Greece,Europe,2022,12,15,10,37,14,11,11,14,50,87
Grenada,Americas,2022,11,16,10,37,15,11,13,13,52,89
Guatemala,Americas,2022,7,10,4,21,11,6,5,8,30,51
Guinea,Africa,2022,1,7,2,10,10,4,4,6,24,34
Guinea-Bissau,Africa,2022,7,8,2,17,10,6,5,5,26,43
Guyana,Americas,2022,9,13,8,30,15,11,8,9,43,73
Haiti,Americas,2022,3,5,3,11,9,4,4,5,22,33
Honduras,Americas,2022,8,9,4,21,9,5,4,8,26,47
Hungary,Europe,2022,9,11,6,26,10,10,10,13,43,69
Iceland,Europe,2022,12,15,10,37,15,12,15,15,57,94
India,Asia,2022,12,12,9,33,9,7,8,9,33,66
Indonesia,Asia,2022,11,13,6,30,9,6,5,9,29,59
Iran,Middle East,2022,2,2,0,4,2,1,3,4,10,14
Iraq,Middle East,2022,8,8,2,16,4,4,1,4,13,29
Ireland,Europe,2022,12,16,11,39,16,12,14,16,58,97
Israel,Middle East,2022,12,13,9,34,12,8,11,11,42,76
Italy,Europe,2022,12,14,10,36,15,12,13,14,54,90
Jamaica,Americas,2022,12,13,9,34,15,11,9,11,46,80
Japan,Asia,2022,12,16,12,40,15,12,15,14,56,96
Jordan,Middle East,2022,2,6,3,11,7,1,7,7,22,33
Kazakhstan,Eurasia,2022,1,3,1,5,4,2,4,8,18,23
Kenya,Africa,2022,6,8,5,19,10,7,5,7,29,48
Kiribati,Asia,2022,12,15,10,37,16,12,15,13,56,93
Kosovo,Europe,2022,9,11,5,25,9,8,6,8,31,56
Kuwait,Middle East,2022,3,7,4,14,6,4,7,6,23,37
Kyrgyzstan,Eurasia,2022,2,4,0,4,10,4,2,7,23,27
Laos,Asia,2022,0,0,2,2,3,0,2,6,11,13
Latvia,Europe,2022,12,15,10,37,14,12,11,14,51,88
Lebanon,Middle East,2022,5,7,1,13,10,8,5,6,29,42
Lesotho,Africa,2022,10,11,6,27,12,7,8,9,36,63
Liberia,Africa,2022,8,12,7,27,11,7,6,9,33,60
Libya,Africa,2022,0,1,0,1,4,2,0,2,8,9
Liechtenstein,Europe,2022,10,13,10,33,16,12,14,15,57,90
Lithuania,Europe,2022,12,16,10,38,15,11,11,14,51,89
Luxembourg,Europe,2022,12,16,10,38,16,12,15,16,59,97
Madagascar,Africa,2022,9,11,7,27,11,8,7,8,34,61
Malawi,Africa,2022,9,12,8,29,13,8,9,7,37,66
Malaysia,Asia,2022,6,9,5,20,8,6,7,9,30,50
Maldives,Asia,2022,7,8,4,19,3,5,6,7,21,40
Mali,Africa,2022,1,5,2,8,10,6,4,4,24,32
Malta,Europe,2022,12,14,9,35,14,12,14,14,54,89
Marshall Islands,Asia,2022,12,16,10,38,16,11,15,13,55,93
Mauritania,Africa,2022,6,4,4,14,9,4,4,4,21,35
Mauritius,Africa,2022,11,15,10,36,14,11,13,12,50,86
Mexico,Americas,2022,9,13,5,27,12,7,5,9,33,60
Micronesia,Asia,2022,12,15,10,37,16,11,15,13,55,92
Moldova,Eurasia,2022,10,12,5,27,12,8,6,9,35,62
Monaco,Europe,2022,8,10,9,27,16,12,14,15,57,84
Mongolia,Asia,2022,11,16,9,36,14,11,11,12,48,84
Montenegro,Europe,2022,9,11,6,26,12,9,9,11,41,67
Morocco,Africa,2022,5,5,3,13,7,5,5,7,24,37
Mozambique,Africa,2022,3,7,4,14,9,6,6,8,29,43
Myanmar,Asia,2022,0,7,1,0,3,2,0,4,9,9
Namibia,Africa,2022,11,12,8,31,14,11,11,10,46,77
Nauru,Asia,2022,12,14,8,34,13,9,9,12,43,77
Nepal,Asia,2022,10,10,5,25,10,7,7,8,32,57
Netherlands,Europe,2022,12,16,11,39,16,12,15,15,58,97
New Zealand,Asia,2022,12,16,12,40,16,12,15,16,59,99
Nicaragua,Americas,2022,0,3,2,5,5,2,3,8,18,23
Niger,Africa,2022,8,9,6,23,10,6,6,6,28,51
Nigeria,Africa,2022,6,9,5,20,9,6,4,4,23,43
North Korea,Asia,2022,0,0,0,0,0,0,0,3,3,3
North Macedonia,Europe,2022,9,12,7,28,12,8,9,10,39,67
Norway,Europe,2022,12,16,12,40,16,12,16,16,60,100
Oman,Middle East,2022,2,2,2,6,5,4,4,5,18,24
Pakistan,Asia,2022,5,6,4,15,6,6,4,6,22,37
Palau,Asia,2022,12,15,10,37,16,11,15,13,55,92
Panama,Americas,2022,12,15,8,35,15,11,10,12,48,83
Papua New Guinea,Asia,2022,7,13,3,23,14,10,7,8,39,62
Paraguay,Americas,2022,10,12,6,28,12,8,7,10,37,65
Peru,Americas,2022,10,13,7,30,15,8,8,11,42,72
Philippines,Asia,2022,9,10,6,25,11,6,3,10,30,55
Poland,Europe,2022,10,16,8,34,13,10,10,14,47,81
Portugal,Europe,2022,12,16,11,39,16,11,14,15,56,95
Qatar,Middle East,2022,2,2,3,7,7,2,5,4,18,25
Romania,Europe,2022,12,14,9,35,13,11,12,12,48,83
Russia,Eurasia,2022,0,3,2,5,3,2,2,7,14,19
Rwanda,Africa,2022,2,2,4,8,3,2,2,7,14,22
Samoa,Asia,2022,9,14,9,32,14,11,14,12,51,83
San Marino,Europe,2022,12,15,11,38,15,12,13,15,55,93
Sao Tome and Principe,Africa,2022,11,15,9,35,15,11,12,11,49,84
Saudi Arabia,Middle East,2022,0,0,1,1,2,0,2,2,6,7
Senegal,Africa,2022,9,12,8,29,13,7,8,11,39,68
Serbia,Europe,2022,7,9,5,21,12,8,9,12,41,62
Seychelles,Africa,2022,12,13,9,34,14,9,11,11,45,79
Sierra Leone,Africa,2022,10,11,7,28,12,6,9,10,37,65
Singapore,Asia,2022,4,8,7,19,7,3,7,11,28,47
Slovakia,Europe,2022,12,15,10,37,15,12,12,14,53,90
Slovenia,Europe,2022,12,16,10,38,14,10,14,14,52,90
Solomon Islands,Asia,2022,9,14,7,30,16,10,11,12,49,79
Somalia,Africa,2022,0,1,0,1,3,3,0,0,6,7
South Africa,Africa,2022,12,13,8,33,15,12,9,10,46,79
South Korea,Asia,2022,11,13,9,33,14,11,12,13,50,83
South Sudan,Africa,2022,0,5,0,-3,2,2,0,0,4,1
Spain,Europe,2022,12,16,9,37,14,11,13,15,53,90
Sri Lanka,Asia,2022,9,11,5,23,8,9,7,8,32,55
St. Kitts and Nevis,Americas,2022,10,15,10,35,16,12,13,13,54,89
St. Lucia,Americas,2022,11,16,11,38,15,12,13,14,54,92
St. Vincent and the Grenadines,Americas,2022,11,15,10,36,15,12,14,14,55,91
Sudan,Africa,2022,0,4,0,0,5,2,0,3,10,10
Suriname,Americas,2022,11,14,9,34,15,11,9,10,45,79
Sweden,Europe,2022,12,16,12,40,16,12,16,16,60,100
Switzerland,Europe,2022,12,15,12,39,15,12,15,15,57,96
Syria,Middle East,2022,0,3,0,-3,3,0,0,1,4,1
Taiwan,Asia,2022,12,15,11,38,16,11,15,14,56,94
Tajikistan,Eurasia,2022,0,0,0,0,1,2,1,4,8,8
Tanzania,Africa,2022,3,5,4,12,7,4,4,7,22,34
Thailand,Asia,2022,1,2,2,5,6,3,5,10,24,29
The Gambia,Africa,2022,8,9,4,21,8,6,6,6,26,47
Timor-Leste,Asia,2022,11,14,8,33,14,8,8,9,39,72
Togo,Africa,2022,4,6,5,15,9,5,6,7,27,42
Tonga,Asia,2022,9,14,7,30,14,10,12,13,49,79
Trinidad and Tobago,Americas,2022,11,13,9,33,16,11,9,13,49,82
Tunisia,Africa,2022,9,13,4,26,12,7,9,10,38,64
Turkey,Europe,2022,5,8,3,16,5,3,3,5,16,32
Turkmenistan,Eurasia,2022,0,0,0,0,0,0,0,2,2,2
Tuvalu,Asia,2022,12,15,10,37,16,12,15,13,56,93
Uganda,Africa,2022,3,5,3,11,8,4,4,7,23,34
Ukraine,Eurasia,2022,9,12,5,26,11,8,6,10,35,61
United Arab Emirates,Middle East,2022,1,2,2,5,3,2,3,4,12,17
United Kingdom,Europe,2022,12,16,11,39,14,12,13,15,54,93
United States,Americas,2022,10,13,9,32,14,11,11,15,51,83
Uruguay,Americas,2022,12,16,12,40,16,12,14,15,57,97
Uzbekistan,Eurasia,2022,1,0,1,2,3,1,1,4,9,11
Vanuatu,Asia,2022,10,15,8,33,14,11,13,11,49,82
Venezuela,Americas,2022,0,1,0,1,6,2,1,4,13,14
Vietnam,Asia,2022,0,1,2,3,3,1,4,8,16,19
Yemen,Middle East,2022,0,1,0,1,2,3,1,2,8,9
Zambia,Africa,2022,6,11,4,21,8,6,8,8,30,51
Zimbabwe,Africa,2022,3,5,3,11,7,3,2,5,17,28
Afghanistan,Asia,2021,3,7,3,13,6,4,2,2,14,27
Albania,Europe,2021,8,12,7,27,13,8,9,9,39,66
Algeria,Africa,2021,3,4,3,10,6,3,6,7,22,32
Andorra,Europe,2021,12,15,11,38,14,11,15,15,55,93
Angola,Africa,2021,3,5,2,10,7,6,5,3,21,31
Antigua and Barbuda,Americas,2021,12,13,8,33,15,10,14,13,52,85
Argentina,Americas,2021,11,16,8,35,15,11,10,13,49,84
Armenia,Eurasia,2021,6,10,6,22,9,8,6,10,33,55
Australia,Asia,2021,12,16,12,40,15,12,15,15,57,97
Austria,Europe,2021,12,15,10,37,14,12,15,15,56,93
Azerbaijan,Eurasia,2021,0,2,0,2,2,1,0,5,8,10
Bahamas,Americas,2021,12,16,10,38,15,12,13,13,53,91
Bahrain,Middle East,2021,2,2,2,2,2,1,1,6,10,12
Bangladesh,Asia,2021,4,7,4,15,6,5,4,9,24,39
Barbados,Americas,2021,12,16,10,38,16,12,14,15,57,95
Belarus,Eurasia,2021,0,1,1,2,2,1,1,5,9,11
Belgium,Europe,2021,12,16,11,39,15,12,15,15,57,96
Belize,Americas,2021,12,14,8,34,16,11,13,13,53,87
Benin,Africa,2021,5,9,7,21,14,9,11,10,44,65
Bhutan,Asia,2021,10,13,9,30,9,5,8,9,31,61
Bolivia,Americas,2021,10,10,7,27,14,9,6,10,39,66
Bosnia and Herzegovina,Europe,2021,6,9,4,19,10,7,7,10,34,53
Botswana,Africa,2021,10,10,8,28,12,10,11,11,44,72
Brazil,Americas,2021,10,14,7,31,14,9,8,12,43,74
Brunei,Asia,2021,0,3,4,7,6,3,5,7,21,28
Bulgaria,Europe,2021,11,14,8,33,13,11,10,11,45,78
Burkina Faso,Africa,2021,7,10,6,23,11,8,5,7,31,54
Burundi,Africa,2021,1,3,0,4,4,1,1,4,10,14
Cabo Verde,Africa,2021,12,16,10,38,16,11,14,13,54,92
Cambodia,Asia,2021,1,2,2,5,7,3,3,6,19,24
Cameroon,Africa,2021,1,3,3,7,4,2,0,3,9,16
Canada,Americas,2021,12,16,12,40,15,12,15,16,58,98
Central African Republic,Africa,2021,2,3,0,3,4,1,1,0,6,9
Chad,Africa,2021,1,1,1,3,6,4,1,3,14,17
Chile,Americas,2021,12,15,11,38,16,11,13,15,55,93
China,Asia,2021,0,3,1,-2,1,2,2,6,11,9
Colombia,Americas,2021,10,11,8,29,12,6,9,9,36,65
Comoros,Africa,2021,5,7,4,16,8,6,6,6,26,42
Congo (Brazzaville),Africa,2021,0,2,0,2,7,4,1,6,18,20
Congo (Kinshasa),Africa,2021,1,2,2,5,7,3,1,4,15,20
Costa Rica,Americas,2021,12,15,11,38,16,11,13,13,53,91
"Cote d'Ivoire",Africa,2021,5,7,4,16,9,6,6,7,28,44
Croatia,Europe,2021,12,14,10,36,13,12,11,13,49,85
Cuba,Americas,2021,0,0,1,1,4,0,2,6,12,13
Cyprus,Europe,2021,12,15,11,38,15,12,15,14,56,94
Czech Republic,Europe,2021,12,15,9,36,14,12,14,15,55,91
Denmark,Europe,2021,12,16,12,40,16,12,14,15,57,97
Djibouti,Africa,2021,2,3,0,5,6,3,4,6,19,24
Dominica,Americas,2021,11,16,10,37,15,11,15,15,56,93
Dominican Republic,Americas,2021,9,10,7,26,14,10,8,9,41,67
Ecuador,Americas,2021,8,12,7,27,13,9,8,10,40,67
Egypt,Africa,2021,2,2,2,6,3,1,2,6,12,18
El Salvador,Americas,2021,11,13,6,30,11,8,7,7,33,63
Equatorial Guinea,Africa,2021,0,0,0,0,2,0,0,3,5,5
Eritrea,Africa,2021,0,0,1,1,0,0,0,1,1,2
Estonia,Europe,2021,12,15,11,38,16,12,14,14,56,94
Eswatini,Africa,2021,0,1,0,1,5,3,5,5,18,19
Ethiopia,Africa,2021,2,4,3,9,4,4,2,3,13,22
Fiji,Asia,2021,8,9,7,24,12,7,7,10,36,60
Finland,Europe,2021,12,16,12,40,16,12,16,16,60,100
France,Europe,2021,12,15,11,38,14,11,13,14,52,90
Gabon,Africa,2021,0,2,1,3,8,3,3,5,19,22
Georgia,Eurasia,2021,7,9,7,23,10,7,8,12,37,60
Germany,Europe,2021,12,15,12,39,14,12,14,15,55,94
Ghana,Africa,2021,12,13,10,35,14,11,11,11,47,82
Greece,Europe,2021,12,15,10,37,14,11,11,14,50,87
Grenada,Americas,2021,11,16,10,37,15,11,13,13,52,89
Guatemala,Americas,2021,7,10,4,21,11,6,6,8,31,52
Guinea,Africa,2021,4,7,3,14,10,4,4,6,24,38
Guinea-Bissau,Africa,2021,7,8,2,17,10,7,5,5,27,44
Guyana,Americas,2021,9,13,8,30,15,11,8,9,43,73
Haiti,Americas,2021,4,7,4,15,10,3,4,5,22,37
Honduras,Americas,2021,7,8,4,19,9,4,4,8,25,44
Hungary,Europe,2021,9,11,6,26,10,10,10,13,43,69
Iceland,Europe,2021,12,15,10,37,15,12,15,15,57,94
India,Asia,2021,12,13,9,34,9,7,8,9,33,67
Indonesia,Asia,2021,11,13,6,30,9,6,5,9,29,59
Iran,Middle East,2021,3,2,1,6,2,1,3,4,10,16
Iraq,Middle East,2021,8,8,2,16,4,4,1,4,13,29
Ireland,Europe,2021,12,16,11,39,16,12,14,16,58,97
Israel,Middle East,2021,12,13,8,33,12,9,11,11,43,76
Italy,Europe,2021,12,14,10,36,15,12,13,14,54,90
Jamaica,Americas,2021,12,13,9,34,15,11,9,11,46,80
Japan,Asia,2021,12,16,12,40,15,12,15,14,56,96
Jordan,Middle East,2021,2,6,3,11,7,1,7,8,23,34
Kazakhstan,Eurasia,2021,1,3,1,5,4,2,4,8,18,23
Kenya,Africa,2021,6,8,5,19,10,7,5,7,29,48
Kiribati,Asia,2021,12,15,10,37,16,12,15,13,56,93
Kosovo,Europe,2021,8,10,5,23,9,8,6,8,31,54
Kuwait,Middle East,2021,3,7,4,14,6,4,7,6,23,37
Kyrgyzstan,Eurasia,2021,2,4,0,4,10,5,2,7,24,28
Laos,Asia,2021,0,0,2,2,3,0,2,6,11,13
Latvia,Europe,2021,12,15,10,37,14,12,12,14,52,89
Lebanon,Middle East,2021,5,7,1,13,11,8,5,6,30,43
Lesotho,Africa,2021,10,11,6,27,12,7,8,9,36,63
Liberia,Africa,2021,8,12,7,27,11,7,6,9,33,60
Libya,Africa,2021,0,1,0,1,4,2,0,2,8,9
Liechtenstein,Europe,2021,10,13,10,33,16,12,14,15,57,90
Lithuania,Europe,2021,12,16,10,38,15,11,12,14,52,90
Luxembourg,Europe,2021,12,16,10,38,16,12,15,16,59,97
Madagascar,Africa,2021,9,11,7,27,10,8,7,8,33,60
Malawi,Africa,2021,9,12,8,29,13,8,9,7,37,66
Malaysia,Asia,2021,6,9,6,21,8,6,7,9,30,51
Maldives,Asia,2021,7,8,4,19,3,5,6,7,21,40
Mali,Africa,2021,2,5,2,9,10,6,4,4,24,33
Malta,Europe,2021,12,14,9,35,14,12,15,14,55,90
Marshall Islands,Asia,2021,12,16,10,38,16,11,15,13,55,93
Mauritania,Africa,2021,6,4,4,14,9,4,4,4,21,35
Mauritius,Africa,2021,12,15,10,37,14,11,13,12,50,87
Mexico,Americas,2021,9,13,5,27,13,7,5,9,34,61
Micronesia,Asia,2021,12,15,10,37,16,11,15,13,55,92
Moldova,Eurasia,2021,9,12,5,26,12,8,6,9,35,61
Monaco,Europe,2021,8,10,8,26,16,12,14,15,57,83
Mongolia,Asia,2021,11,16,9,36,14,11,11,12,48,84
Montenegro,Europe,2021,9,10,5,24,10,9,9,11,39,63
Morocco,Africa,2021,5,5,3,13,7,5,5,7,24,37
Mozambique,Africa,2021,3,7,4,14,9,6,6,8,29,43
Myanmar,Asia,2021,5,12,4,13,5,5,1,4,15,28
Namibia,Africa,2021,11,12,8,31,14,11,11,10,46,77
Nauru,Asia,2021,12,14,8,34,13,9,9,12,43,77
Nepal,Asia,2021,10,10,5,25,10,7,6,8,31,56
Netherlands,Europe,2021,12,16,12,40,16,12,15,15,58,98
New Zealand,Asia,2021,12,16,12,40,16,12,15,16,59,99
Nicaragua,Americas,2021,3,4,3,10,7,2,3,8,20,30
Niger,Africa,2021,6,8,6,20,10,6,6,6,28,48
Nigeria,Africa,2021,6,10,5,21,9,6,4,5,24,45
North Korea,Asia,2021,0,0,0,0,0,0,0,3,3,3
North Macedonia,Europe,2021,9,11,7,27,12,8,9,10,39,66
Norway,Europe,2021,12,16,12,40,16,12,16,16,60,100
Oman,Middle East,2021,2,2,2,6,5,3,4,5,17,23
Pakistan,Asia,2021,5,6,4,15,6,6,4,6,22,37
Palau,Asia,2021,12,15,10,37,16,11,15,13,55,92
Panama,Americas,2021,12,15,8,35,15,11,10,12,48,83
Papua New Guinea,Asia,2021,7,13,3,23,14,10,7,8,39,62
Paraguay,Americas,2021,10,12,6,28,12,8,7,10,37,65
Peru,Americas,2021,10,13,6,29,15,8,8,11,42,71
Philippines,Asia,2021,9,10,6,25,12,6,3,10,31,56
Poland,Europe,2021,10,16,8,34,13,10,11,14,48,82
Portugal,Europe,2021,12,16,11,39,16,12,14,15,57,96
Qatar,Middle East,2021,2,2,3,7,7,2,5,4,18,25
Romania,Europe,2021,12,14,9,35,13,11,12,12,48,83
Russia,Eurasia,2021,0,3,2,5,3,3,2,7,15,20
Rwanda,Africa,2021,2,2,4,8,3,2,2,6,13,21
Samoa,Asia,2021,9,12,9,30,14,11,14,12,51,81
San Marino,Europe,2021,12,15,11,38,15,12,13,15,55,93
Sao Tome and Principe,Africa,2021,11,15,9,35,15,11,12,11,49,84
Saudi Arabia,Middle East,2021,0,0,1,1,2,0,2,2,6,7
Senegal,Africa,2021,9,12,8,29,13,9,9,11,42,71
Serbia,Europe,2021,7,10,5,22,12,9,9,12,42,64
Seychelles,Africa,2021,12,13,9,34,12,9,11,11,43,77
Sierra Leone,Africa,2021,10,11,7,28,12,6,9,10,37,65
Singapore,Asia,2021,4,8,7,19,8,3,7,11,29,48
Slovakia,Europe,2021,12,15,10,37,15,12,12,14,53,90
Slovenia,Europe,2021,12,16,11,39,15,12,15,14,56,95
Solomon Islands,Asia,2021,9,14,7,30,16,10,11,12,49,79
Somalia,Africa,2021,0,1,0,1,3,3,0,0,6,7
South Africa,Africa,2021,12,13,8,33,15,12,9,10,46,79
South Korea,Asia,2021,11,13,9,33,14,11,12,13,50,83
South Sudan,Africa,2021,1,5,0,-2,2,2,0,0,4,2
Spain,Europe,2021,12,16,9,37,14,11,13,15,53,90
Sri Lanka,Asia,2021,9,11,5,23,8,9,8,8,33,56
St. Kitts and Nevis,Americas,2021,10,15,10,35,16,12,13,13,54,89
St. Lucia,Americas,2021,11,16,10,37,15,12,13,14,54,91
St. Vincent and the Grenadines,Americas,2021,11,15,10,36,15,12,14,14,55,91
Sudan,Africa,2021,0,6,0,2,7,4,1,3,15,17
Suriname,Americas,2021,11,14,9,34,15,11,9,10,45,79
Sweden,Europe,2021,12,16,12,40,16,12,16,16,60,100
Switzerland,Europe,2021,12,15,12,39,15,12,15,15,57,96
Syria,Middle East,2021,0,3,0,-3,3,0,0,1,4,1
Taiwan,Asia,2021,12,15,11,38,16,11,15,14,56,94
Tajikistan,Eurasia,2021,0,0,0,0,1,2,1,4,8,8
Tanzania,Africa,2021,3,5,4,12,7,4,4,7,22,34
Thailand,Asia,2021,1,2,2,5,6,4,5,10,25,30
The Gambia,Africa,2021,7,9,4,20,8,6,6,6,26,46
Timor-Leste,Asia,2021,11,14,8,33,14,8,8,9,39,72
Togo,Africa,2021,4,6,5,15,9,6,6,7,28,43
Tonga,Asia,2021,9,14,7,30,14,10,12,13,49,79
Trinidad and Tobago,Americas,2021,11,13,9,33,16,11,9,13,49,82
Tunisia,Africa,2021,12,14,6,32,12,8,9,10,39,71
Turkey,Europe,2021,5,8,3,16,5,3,3,5,16,32
Turkmenistan,Eurasia,2021,0,0,0,0,0,0,0,2,2,2
Tuvalu,Asia,2021,12,15,10,37,16,12,15,13,56,93
Uganda,Africa,2021,3,5,3,11,8,4,4,7,23,34
Ukraine,Eurasia,2021,9,12,5,26,11,7,6,10,34,60
United Arab Emirates,Middle East,2021,1,2,2,5,3,2,3,4,12,17
United Kingdom,Europe,2021,12,16,11,39,14,12,13,15,54,93
United States,Americas,2021,10,14,8,32,15,10,11,15,51,83
Uruguay,Americas,2021,12,16,12,40,16,12,15,15,58,98
Uzbekistan,Eurasia,2021,1,0,1,2,3,1,1,4,9,11
Vanuatu,Asia,2021,10,15,8,33,14,11,13,11,49,82
Venezuela,Americas,2021,0,1,0,1,6,2,1,4,13,14
Vietnam,Asia,2021,0,1,2,3,3,1,4,8,16,19
Yemen,Middle East,2021,0,1,0,1,3,3,2,2,10,11
Zambia,Africa,2021,6,10,4,20,9,7,8,8,32,52
Zimbabwe,Africa,2021,3,5,3,11,7,3,2,5,17,28
Afghanistan,Asia,2020,3,7,3,13,6,4,2,2,14,27
Albania,Europe,2020,8,12,7,27,13,9,9,9,40,67
Algeria,Africa,2020,3,4,3,10,7,4,6,7,24,34
Andorra,Europe,2020,12,15,12,39,14,11,15,15,55,94
Angola,Africa,2020,3,6,2,11,7,6,5,3,21,32
Antigua and Barbuda,Americas,2020,12,13,8,33,15,10,14,13,52,85
Argentina,Americas,2020,11,16,8,35,15,11,10,14,50,85
Armenia,Eurasia,2020,6,10,5,21,9,8,6,9,32,53
Australia,Asia,2020,12,16,12,40,15,12,15,15,57,97
Austria,Europe,2020,12,15,10,37,14,12,15,15,56,93
Azerbaijan,Eurasia,2020,0,2,0,2,2,1,0,5,8,10
Bahamas,Americas,2020,12,16,10,38,15,12,13,13,53,91
Bahrain,Middle East,2020,2,3,2,1,2,1,1,6,10,11
Bangladesh,Asia,2020,4,7,4,15,6,5,4,9,24,39
Barbados,Americas,2020,12,16,10,38,16,12,14,15,57,95
Belarus,Eurasia,2020,0,3,2,5,2,3,2,7,14,19
Belgium,Europe,2020,12,16,11,39,15,12,15,15,57,96
Belize,Americas,2020,12,14,9,35,15,11,12,13,51,86
Benin,Africa,2020,5,9,7,21,15,9,11,10,45,66
Bhutan,Asia,2020,10,12,9,29,9,5,8,8,30,59
Bolivia,Americas,2020,8,10,7,25,14,8,6,10,38,63
Bosnia and Herzegovina,Europe,2020,6,9,4,19,10,7,7,10,34,53
Botswana,Africa,2020,10,10,8,28,12,10,11,11,44,72
Brazil,Americas,2020,10,14,7,31,14,9,8,13,44,75
Brunei,Asia,2020,0,3,4,7,6,3,5,7,21,28
Bulgaria,Europe,2020,11,14,9,34,13,11,10,12,46,80
Burkina Faso,Africa,2020,7,10,6,23,11,8,6,8,33,56
Burundi,Africa,2020,0,3,0,3,4,1,1,4,10,13
Cabo Verde,Africa,2020,12,16,10,38,16,11,14,13,54,92
Cambodia,Asia,2020,1,2,2,5,8,3,3,6,20,25
Cameroon,Africa,2020,1,3,3,7,4,2,1,4,11,18
Canada,Americas,2020,12,16,12,40,15,12,15,16,58,98
Central African Republic,Africa,2020,3,3,0,4,4,1,1,0,6,10
Chad,Africa,2020,1,1,1,3,6,4,1,3,14,17
Chile,Americas,2020,12,15,11,38,15,10,13,14,52,90
China,Asia,2020,0,3,2,-1,1,2,2,6,11,10
Colombia,Americas,2020,10,11,8,29,12,6,9,10,37,66
Comoros,Africa,2020,6,8,4,18,8,6,6,6,26,44
Congo (Brazzaville),Africa,2020,0,2,0,2,7,4,1,6,18,20
Congo (Kinshasa),Africa,2020,1,2,1,4,7,3,0,4,14,18
Costa Rica,Americas,2020,12,15,11,38,16,11,13,13,53,91
"Cote d'Ivoire",Africa,2020,7,8,4,19,11,8,6,7,32,51
Croatia,Europe,2020,12,14,10,36,13,12,11,13,49,85
Cuba,Americas,2020,0,0,1,1,5,0,2,6,13,14
Cyprus,Europe,2020,12,15,11,38,15,12,15,14,56,94
Czech Republic,Europe,2020,12,15,9,36,14,12,14,15,55,91
Denmark,Europe,2020,12,16,12,40,16,12,14,15,57,97
Djibouti,Africa,2020,2,3,0,5,6,3,4,6,19,24
Dominica,Americas,2020,11,16,10,37,15,11,15,15,56,93
Dominican Republic,Americas,2020,9,10,7,26,14,10,8,9,41,67
Ecuador,Americas,2020,8,12,7,27,12,8,8,10,38,65
Egypt,Africa,2020,2,3,2,7,4,1,3,6,14,21
El Salvador,Americas,2020,11,13,8,32,11,8,7,8,34,66
Equatorial Guinea,Africa,2020,0,0,0,0,3,0,0,3,6,6
Eritrea,Africa,2020,0,0,1,1,0,0,0,1,1,2
Estonia,Europe,2020,12,15,11,38,16,12,14,14,56,94
Eswatini,Africa,2020,0,1,0,1,5,3,5,5,18,19
Ethiopia,Africa,2020,2,5,3,10,4,4,2,4,14,24
Fiji,Asia,2020,8,9,7,24,12,7,7,10,36,60
Finland,Europe,2020,12,16,12,40,16,12,16,16,60,100
France,Europe,2020,12,15,11,38,14,11,13,14,52,90
Gabon,Africa,2020,0,2,1,3,8,3,3,5,19,22
Georgia,Eurasia,2020,8,9,7,24,10,7,8,12,37,61
Germany,Europe,2020,12,15,12,39,14,12,14,15,55,94
Ghana,Africa,2020,12,13,10,35,14,11,11,11,47,82
Greece,Europe,2020,12,15,10,37,14,12,11,14,51,88
Grenada,Americas,2020,11,16,10,37,15,11,13,13,52,89
Guatemala,Americas,2020,7,10,4,21,11,6,6,8,31,52
Guinea,Africa,2020,5,7,3,15,11,4,4,6,25,40
Guinea-Bissau,Africa,2020,7,8,2,17,11,8,5,5,29,46
Guyana,Americas,2020,10,13,8,31,15,11,8,9,43,74
Haiti,Americas,2020,5,7,4,16,10,3,4,5,22,38
Honduras,Americas,2020,7,8,4,19,9,4,5,8,26,45
Hungary,Europe,2020,9,11,7,27,10,10,10,13,43,70
Iceland,Europe,2020,12,15,10,37,15,12,15,15,57,94
India,Asia,2020,12,13,9,34,10,8,9,10,37,71
Indonesia,Asia,2020,11,13,6,30,10,7,5,9,31,61
Iran,Middle East,2020,3,2,2,7,2,1,3,4,10,17
Iraq,Middle East,2020,8,9,2,17,5,4,1,4,14,31
Ireland,Europe,2020,12,16,11,39,16,12,14,16,58,97
Israel,Middle East,2020,12,13,8,33,12,9,11,11,43,76
Italy,Europe,2020,12,14,10,36,15,12,12,14,53,89
Jamaica,Americas,2020,12,13,9,34,15,10,8,11,44,78
Japan,Asia,2020,12,16,12,40,15,12,15,14,56,96
Jordan,Middle East,2020,3,6,3,12,7,3,7,8,25,37
Kazakhstan,Eurasia,2020,1,3,1,5,4,2,4,8,18,23
Kenya,Africa,2020,6,8,5,19,10,7,5,7,29,48
Kiribati,Asia,2020,12,15,10,37,16,12,15,13,56,93
Kosovo,Europe,2020,9,11,5,25,9,8,6,8,31,56
Kuwait,Middle East,2020,2,7,4,13,6,4,7,6,23,36
Kyrgyzstan,Eurasia,2020,4,6,4,12,10,6,4,7,27,39
Laos,Asia,2020,0,0,2,2,4,0,2,6,12,14
Latvia,Europe,2020,12,15,10,37,14,12,12,14,52,89
Lebanon,Middle East,2020,5,7,2,14,11,8,5,6,30,44
Lesotho,Africa,2020,10,11,6,27,12,7,8,9,36,63
Liberia,Africa,2020,8,12,7,27,11,7,6,9,33,60
Libya,Africa,2020,0,1,0,1,4,2,0,2,8,9
Liechtenstein,Europe,2020,10,13,10,33,16,12,14,15,57,90
Lithuania,Europe,2020,12,16,10,38,16,11,12,14,53,91
Luxembourg,Europe,2020,12,16,10,38,16,12,16,16,60,98
Madagascar,Africa,2020,9,11,6,26,11,9,7,8,35,61
Malawi,Africa,2020,8,12,6,26,13,7,9,7,36,62
Malaysia,Asia,2020,6,9,6,21,9,6,7,9,31,52
Maldives,Asia,2020,7,7,4,18,3,6,6,7,22,40
Mali,Africa,2020,5,8,4,17,10,6,4,4,24,41
Malta,Europe,2020,12,14,9,35,14,12,15,14,55,90
Marshall Islands,Asia,2020,12,16,10,38,16,11,15,13,55,93
Mauritania,Africa,2020,6,3,4,13,9,4,4,4,21,34
Mauritius,Africa,2020,12,15,10,37,15,12,13,12,52,89
Mexico,Americas,2020,9,13,5,27,13,7,5,10,35,62
Micronesia,Asia,2020,12,15,10,37,16,11,15,13,55,92
Moldova,Eurasia,2020,9,12,5,26,11,8,6,9,34,60
Monaco,Europe,2020,8,10,8,26,16,12,14,15,57,83
Mongolia,Asia,2020,11,16,9,36,14,11,11,12,48,84
Montenegro,Europe,2020,8,9,5,22,11,9,9,11,40,62
Morocco,Africa,2020,5,5,3,13,7,5,5,7,24,37
Mozambique,Africa,2020,3,7,4,14,9,6,7,9,31,45
Myanmar,Asia,2020,5,13,4,14,5,6,1,4,16,30
Namibia,Africa,2020,11,12,8,31,14,11,11,10,46,77
Nauru,Asia,2020,12,14,8,34,13,9,9,12,43,77
Nepal,Asia,2020,10,10,5,25,10,7,6,8,31,56
Netherlands,Europe,2020,12,16,12,40,16,12,15,16,59,99
New Zealand,Asia,2020,12,16,12,40,16,12,14,15,57,97
Nicaragua,Americas,2020,3,4,3,10,7,2,4,8,21,31
Niger,Africa,2020,6,8,6,20,10,6,6,6,28,48
Nigeria,Africa,2020,6,10,6,22,9,7,4,5,25,47
North Korea,Asia,2020,0,0,0,0,0,0,0,3,3,3
North Macedonia,Europe,2020,7,11,6,24,12,8,9,10,39,63
Norway,Europe,2020,12,16,12,40,16,12,16,16,60,100
Oman,Middle East,2020,2,2,2,6,5,3,4,5,17,23
Pakistan,Asia,2020,5,6,5,16,6,6,4,6,22,38
Palau,Asia,2020,12,15,10,37,16,11,15,13,55,92
Panama,Americas,2020,12,15,9,36,15,11,10,12,48,84
Papua New Guinea,Asia,2020,7,13,3,23,14,10,7,8,39,62
Paraguay,Americas,2020,10,12,6,28,12,8,7,10,37,65
Peru,Americas,2020,11,13,6,30,15,8,8,11,42,72
Philippines,Asia,2020,9,10,6,25,14,7,3,10,34,59
Poland,Europe,2020,11,16,8,35,14,10,11,14,49,84
Portugal,Europe,2020,12,16,11,39,16,12,14,15,57,96
Qatar,Middle East,2020,2,2,3,7,7,2,5,4,18,25
Romania,Europe,2020,12,14,9,35,13,11,12,12,48,83
Russia,Eurasia,2020,0,3,2,5,3,3,2,7,15,20
Rwanda,Africa,2020,2,2,4,8,3,2,2,7,14,22
Samoa,Asia,2020,9,12,9,30,14,11,14,12,51,81
San Marino,Europe,2020,12,15,11,38,15,12,15,15,57,95
Sao Tome and Principe,Africa,2020,11,15,9,35,15,11,12,11,49,84
Saudi Arabia,Middle East,2020,0,0,1,1,2,0,2,2,6,7
Senegal,Africa,2020,9,12,8,29,13,9,9,11,42,71
Serbia,Europe,2020,8,10,5,23,12,10,9,12,43,66
Seychelles,Africa,2020,10,11,8,29,12,9,11,11,43,72
Sierra Leone,Africa,2020,10,11,7,28,12,6,9,10,37,65
Singapore,Asia,2020,4,8,7,19,8,4,7,12,31,50
Slovakia,Europe,2020,12,15,9,36,14,12,12,14,52,88
Slovenia,Europe,2020,12,16,11,39,14,12,15,14,55,94
Solomon Islands,Asia,2020,9,14,7,30,16,10,11,12,49,79
Somalia,Africa,2020,0,1,0,1,3,3,0,0,6,7
South Africa,Africa,2020,12,13,8,33,15,12,9,10,46,79
South Korea,Asia,2020,11,13,9,33,14,11,12,13,50,83
South Sudan,Africa,2020,1,5,0,-2,2,2,0,0,4,2
Spain,Europe,2020,12,16,10,38,14,11,14,15,54,92
Sri Lanka,Asia,2020,9,11,5,23,8,9,8,8,33,56
St. Kitts and Nevis,Americas,2020,10,16,10,36,15,12,13,13,53,89
St. Lucia,Americas,2020,11,16,11,38,15,12,13,14,54,92
St. Vincent and the Grenadines,Americas,2020,11,15,10,36,15,12,14,14,55,91
Sudan,Africa,2020,0,6,0,2,5,3,1,1,10,12
Suriname,Americas,2020,11,14,7,32,14,11,8,10,43,75
Sweden,Europe,2020,12,16,12,40,16,12,16,16,60,100
Switzerland,Europe,2020,12,15,12,39,15,12,15,15,57,96
Syria,Middle East,2020,0,3,0,-3,3,0,0,0,3,0
Taiwan,Asia,2020,12,15,10,37,16,11,15,14,56,93
Tajikistan,Eurasia,2020,0,0,0,0,2,2,1,4,9,9
Tanzania,Africa,2020,6,6,5,17,7,4,5,7,23,40
Thailand,Asia,2020,1,3,2,6,6,5,5,10,26,32
The Gambia,Africa,2020,7,9,4,20,8,6,6,6,26,46
Timor-Leste,Asia,2020,11,14,7,32,14,8,8,9,39,71
Togo,Africa,2020,5,6,5,16,9,6,6,7,28,44
Tonga,Asia,2020,9,14,7,30,14,10,12,13,49,79
Trinidad and Tobago,Americas,2020,11,13,9,33,16,11,9,13,49,82
Tunisia,Africa,2020,12,14,6,32,12,7,9,10,38,70
Turkey,Europe,2020,5,8,3,16,5,3,3,5,16,32
Turkmenistan,Eurasia,2020,0,0,0,0,0,0,0,2,2,2
Tuvalu,Asia,2020,12,15,10,37,16,12,15,13,56,93
Uganda,Africa,2020,3,5,3,11,8,4,4,7,23,34
Ukraine,Eurasia,2020,9,12,6,27,11,7,7,10,35,62
United Arab Emirates,Middle East,2020,1,2,2,5,3,2,3,4,12,17
United Kingdom,Europe,2020,12,16,11,39,14,12,14,15,55,94
United States,Americas,2020,10,14,9,33,16,11,11,15,53,86
Uruguay,Americas,2020,12,16,12,40,16,12,15,15,58,98
Uzbekistan,Eurasia,2020,1,0,1,2,2,1,1,4,8,10
Vanuatu,Asia,2020,10,15,8,33,14,11,13,11,49,82
Venezuela,Americas,2020,0,2,0,2,6,2,1,5,14,16
Vietnam,Asia,2020,0,1,2,3,4,1,4,8,17,20
Yemen,Middle East,2020,0,1,0,1,3,3,2,2,10,11
Zambia,Africa,2020,6,10,6,22,9,7,8,8,32,54
Zimbabwe,Africa,2020,3,6,3,12,7,3,2,5,17,29
Afghanistan,Asia,2019,3,7,3,13,6,4,2,2,14,27
Albania,Europe,2019,8,13,7,28,13,9,9,9,40,68
Algeria,Africa,2019,3,4,3,10,7,4,6,7,24,34
Andorra,Europe,2019,12,15,12,39,14,11,15,15,55,94
Angola,Africa,2019,3,6,2,11,7,6,4,3,20,31
Antigua and Barbuda,Americas,2019,12,13,8,33,15,9,14,13,51,84
Argentina,Americas,2019,11,15,8,34,15,11,10,14,50,84
Armenia,Eurasia,2019,6,10,4,20,9,7,6,9,31,51
Australia,Asia,2019,12,16,12,40,16,12,15,15,58,98
Austria,Europe,2019,12,15,10,37,14,12,15,15,56,93
Azerbaijan,Eurasia,2019,0,2,0,2,2,1,1,5,9,11
Bahamas,Americas,2019,12,16,10,38,15,12,13,13,53,91
Bahrain,Middle East,2019,2,3,3,2,2,1,1,6,10,12
Bangladesh,Asia,2019,5,7,5,17,6,5,4,9,24,41
Barbados,Americas,2019,12,16,10,38,16,12,15,15,58,96
Belarus,Eurasia,2019,0,3,2,5,2,3,2,7,14,19
Belgium,Europe,2019,12,16,11,39,15,12,15,15,57,96
Belize,Americas,2019,12,14,10,36,15,10,12,13,50,86
Benin,Africa,2019,9,15,8,32,15,11,11,10,47,79
Bhutan,Asia,2019,10,12,9,29,9,5,8,8,30,59
Bolivia,Americas,2019,10,11,7,28,14,9,6,10,39,67
Bosnia and Herzegovina,Europe,2019,6,9,4,19,10,7,7,10,34,53
Botswana,Africa,2019,10,10,8,28,12,10,11,11,44,72
Brazil,Americas,2019,10,14,6,30,15,9,8,13,45,75
Brunei,Asia,2019,0,3,4,7,6,3,6,7,22,29
Bulgaria,Europe,2019,11,14,8,33,14,11,10,12,47,80
Burkina Faso,Africa,2019,7,10,6,23,13,9,7,8,37,60
Burundi,Africa,2019,0,3,0,3,5,1,1,4,11,14
Cabo Verde,Africa,2019,12,15,10,37,15,11,14,13,53,90
Cambodia,Asia,2019,1,2,3,6,8,3,3,6,20,26
Cameroon,Africa,2019,1,3,3,7,5,2,1,4,12,19
Canada,Americas,2019,12,16,12,40,16,12,15,16,59,99
Central African Republic,Africa,2019,3,3,0,4,4,1,0,0,5,9
Chad,Africa,2019,1,1,1,3,6,4,1,3,14,17
Chile,Americas,2019,12,15,10,37,16,12,14,15,57,94
China,Asia,2019,0,3,2,-1,2,2,2,6,12,11
Colombia,Americas,2019,10,11,8,29,12,6,9,10,37,66
Comoros,Africa,2019,8,9,4,21,10,6,7,6,29,50
Congo (Brazzaville),Africa,2019,0,2,0,2,7,5,1,6,19,21
Congo (Kinshasa),Africa,2019,0,2,1,3,7,1,0,4,12,15
Costa Rica,Americas,2019,12,15,11,38,16,11,13,13,53,91
"Cote d'Ivoire",Africa,2019,7,8,4,19,11,8,6,7,32,51
Croatia,Europe,2019,12,14,10,36,13,12,11,13,49,85
Cuba,Americas,2019,0,0,1,1,5,0,2,6,13,14
Cyprus,Europe,2019,12,15,11,38,15,12,15,14,56,94
Czech Republic,Europe,2019,12,15,9,36,14,12,14,15,55,91
Denmark,Europe,2019,12,16,12,40,16,12,14,15,57,97
Djibouti,Africa,2019,2,3,2,7,6,3,4,6,19,26
Dominica,Americas,2019,11,16,10,37,15,11,15,15,56,93
Dominican Republic,Americas,2019,9,10,7,26,14,10,8,9,41,67
Ecuador,Americas,2019,7,11,7,25,12,9,7,10,38,63
Egypt,Africa,2019,2,3,3,8,4,1,3,6,14,22
El Salvador,Americas,2019,11,13,8,32,12,8,7,8,35,67
Equatorial Guinea,Africa,2019,0,0,0,0,3,0,0,3,6,6
Eritrea,Africa,2019,0,0,1,1,0,0,0,1,1,2
Estonia,Europe,2019,12,15,11,38,16,12,14,14,56,94
Eswatini,Africa,2019,0,1,0,1,5,2,4,4,15,16
Ethiopia,Africa,2019,1,3,3,7,4,2,2,4,12,19
Fiji,Asia,2019,8,9,7,24,12,8,7,10,37,61
Finland,Europe,2019,12,16,12,40,16,12,16,16,60,100
France,Europe,2019,12,15,11,38,14,11,13,14,52,90
Gabon,Africa,2019,0,2,2,4,8,3,3,5,19,23
Georgia,Eurasia,2019,8,10,7,25,10,8,8,12,38,63
Germany,Europe,2019,12,15,12,39,14,12,14,15,55,94
Ghana,Africa,2019,12,14,10,36,14,11,11,11,47,83
Greece,Europe,2019,12,15,9,36,14,12,11,14,51,87
Grenada,Americas,2019,11,16,10,37,15,11,13,13,52,89
Guatemala,Americas,2019,8,10,4,22,11,6,6,8,31,53
Guinea,Africa,2019,6,8,3,17,11,5,4,6,26,43
Guinea-Bissau,Africa,2019,6,8,1,15,11,7,4,5,27,42
Guyana,Americas,2019,11,13,8,32,15,11,8,9,43,75
Haiti,Americas,2019,5,7,5,17,10,4,4,6,24,41
Honduras,Americas,2019,7,8,5,20,9,4,5,8,26,46
Hungary,Europe,2019,9,11,7,27,10,10,10,13,43,70
Iceland,Europe,2019,12,15,10,37,15,12,15,15,57,94
India,Asia,2019,12,14,9,35,11,10,9,10,40,75
Indonesia,Asia,2019,11,13,6,30,11,7,5,9,32,62
Iran,Middle East,2019,3,2,2,7,3,1,3,4,11,18
Iraq,Middle East,2019,8,9,2,17,5,5,1,4,15,32
Ireland,Europe,2019,12,16,11,39,16,12,14,16,58,97
Israel,Middle East,2019,12,13,10,35,12,9,11,11,43,78
Italy,Europe,2019,12,14,10,36,15,12,12,14,53,89
Jamaica,Americas,2019,12,13,9,34,15,10,8,11,44,78
Japan,Asia,2019,12,16,12,40,15,12,15,14,56,96
Jordan,Middle East,2019,3,6,3,12,7,3,7,8,25,37
Kazakhstan,Eurasia,2019,1,3,1,5,4,1,4,8,17,22
Kenya,Africa,2019,6,8,5,19,10,7,5,7,29,48
Kiribati,Asia,2019,12,15,10,37,16,12,15,13,56,93
Kosovo,Europe,2019,9,10,5,24,9,8,6,7,30,54
Kuwait,Middle East,2019,2,7,4,13,6,4,7,6,23,36
Kyrgyzstan,Eurasia,2019,4,6,4,12,10,5,4,7,26,38
Laos,Asia,2019,0,0,2,2,4,0,2,6,12,14
Latvia,Europe,2019,12,14,9,35,14,12,12,14,52,87
Lebanon,Middle East,2019,5,7,2,14,11,8,5,7,31,45
Lesotho,Africa,2019,10,11,6,27,12,7,8,9,36,63
Liberia,Africa,2019,8,12,7,27,11,8,7,9,35,62
Libya,Africa,2019,0,1,0,1,4,2,0,2,8,9
Liechtenstein,Europe,2019,10,13,10,33,16,12,14,15,57,90
Lithuania,Europe,2019,12,16,10,38,16,11,12,14,53,91
Luxembourg,Europe,2019,12,16,10,38,16,12,16,16,60,98
Madagascar,Africa,2019,9,10,5,24,10,8,7,7,32,56
Malawi,Africa,2019,8,12,6,26,14,8,9,7,38,64
Malaysia,Asia,2019,6,9,6,21,9,6,7,9,31,52
Maldives,Asia,2019,5,6,3,14,3,6,5,7,21,35
Mali,Africa,2019,6,8,4,18,10,6,6,4,26,44
Malta,Europe,2019,12,14,9,35,15,12,15,14,56,91
Marshall Islands,Asia,2019,12,16,10,38,16,11,15,13,55,93
Mauritania,Africa,2019,5,2,4,11,9,4,4,4,21,32
Mauritius,Africa,2019,12,15,10,37,15,12,13,12,52,89
Mexico,Americas,2019,9,13,5,27,13,7,6,10,36,63
Micronesia,Asia,2019,12,15,10,37,16,11,15,13,55,92
Moldova,Eurasia,2019,9,11,4,24,11,8,6,9,34,58
Monaco,Europe,2019,8,10,8,26,16,12,14,14,56,82
Mongolia,Asia,2019,11,16,9,36,14,11,12,12,49,85
Montenegro,Europe,2019,8,9,6,23,11,9,10,12,42,65
Morocco,Africa,2019,5,6,3,14,7,5,6,7,25,39
Mozambique,Africa,2019,5,9,5,19,9,7,7,9,32,51
Myanmar,Asia,2019,5,12,4,13,5,6,1,5,17,30
Namibia,Africa,2019,10,11,8,29,14,11,11,10,46,75
Nauru,Asia,2019,12,14,8,34,13,9,10,12,44,78
Nepal,Asia,2019,10,10,5,25,9,6,6,8,29,54
Netherlands,Europe,2019,12,16,12,40,16,12,15,16,59,99
New Zealand,Asia,2019,12,16,12,40,16,12,15,15,58,98
Nicaragua,Americas,2019,3,4,3,10,8,2,4,8,22,32
Niger,Africa,2019,6,8,6,20,11,6,6,6,29,49
Nigeria,Africa,2019,9,10,6,25,9,7,4,5,25,50
North Korea,Asia,2019,0,0,0,0,0,0,0,3,3,3
North Macedonia,Europe,2019,6,10,6,22,11,8,8,10,37,59
Norway,Europe,2019,12,16,12,40,16,12,16,16,60,100
Oman,Middle East,2019,2,2,2,6,5,3,4,5,17,23
Pakistan,Asia,2019,5,7,5,17,6,6,4,6,22,39
Palau,Asia,2019,12,15,10,37,16,11,15,13,55,92
Panama,Americas,2019,12,15,9,36,15,11,10,12,48,84
Papua New Guinea,Asia,2019,7,13,3,23,14,10,8,9,41,64
Paraguay,Americas,2019,10,12,6,28,12,8,7,10,37,65
Peru,Americas,2019,11,13,7,31,15,8,8,11,42,73
Philippines,Asia,2019,9,10,7,26,14,8,3,10,35,61
Poland,Europe,2019,11,16,8,35,14,10,11,14,49,84
Portugal,Europe,2019,12,16,11,39,16,12,14,15,57,96
Qatar,Middle East,2019,2,2,3,7,7,2,5,4,18,25
Romania,Europe,2019,11,14,9,34,13,10,12,12,47,81
Russia,Eurasia,2019,0,3,2,5,3,3,2,7,15,20
Rwanda,Africa,2019,2,2,5,9,3,2,2,7,14,23
Samoa,Asia,2019,9,12,9,30,14,11,14,12,51,81
San Marino,Europe,2019,12,15,11,38,15,12,15,15,57,95
Sao Tome and Principe,Africa,2019,11,14,9,34,15,11,12,11,49,83
Saudi Arabia,Middle East,2019,0,0,1,1,2,0,2,2,6,7
Senegal,Africa,2019,10,12,8,30,13,9,9,11,42,72
Serbia,Europe,2019,8,10,6,24,12,10,9,12,43,67
Seychelles,Africa,2019,10,11,7,28,12,9,11,11,43,71
Sierra Leone,Africa,2019,10,11,7,28,12,6,9,10,37,65
Singapore,Asia,2019,4,8,7,19,9,4,7,12,32,51
Slovakia,Europe,2019,12,15,9,36,14,12,12,14,52,88
Slovenia,Europe,2019,12,16,11,39,14,12,15,14,55,94
Solomon Islands,Asia,2019,9,14,7,30,16,10,11,12,49,79
Somalia,Africa,2019,0,1,0,1,3,3,0,0,6,7
South Africa,Africa,2019,12,13,8,33,15,12,9,10,46,79
South Korea,Asia,2019,11,13,9,33,14,11,12,13,50,83
South Sudan,Africa,2019,1,5,0,-2,2,2,0,0,4,2
Spain,Europe,2019,12,16,11,39,14,11,15,15,55,94
Sri Lanka,Asia,2019,9,11,6,24,8,8,8,8,32,56
St. Kitts and Nevis,Americas,2019,10,16,10,36,15,12,13,13,53,89
St. Lucia,Americas,2019,11,16,11,38,15,12,13,14,54,92
St. Vincent and the Grenadines,Americas,2019,11,15,10,36,15,12,14,14,55,91
Sudan,Africa,2019,2,6,1,3,2,1,0,1,4,7
Suriname,Americas,2019,12,14,8,34,14,11,8,10,43,77
Sweden,Europe,2019,12,16,12,40,16,12,16,16,60,100
Switzerland,Europe,2019,12,15,12,39,15,12,15,15,57,96
Syria,Middle East,2019,0,3,0,-3,3,0,0,0,3,0
Taiwan,Asia,2019,12,15,10,37,16,11,15,14,56,93
Tajikistan,Eurasia,2019,0,0,0,0,2,2,1,4,9,9
Tanzania,Africa,2019,7,7,6,20,7,5,6,7,25,45
Thailand,Asia,2019,0,3,2,5,6,4,5,10,25,30
The Gambia,Africa,2019,7,9,4,20,8,6,5,6,25,45
Timor-Leste,Asia,2019,11,14,7,32,14,8,7,9,38,70
Togo,Africa,2019,4,6,5,15,9,6,6,7,28,43
Tonga,Asia,2019,9,14,7,30,14,10,12,13,49,79
Trinidad and Tobago,Americas,2019,11,13,9,33,16,11,9,13,49,82
Tunisia,Africa,2019,11,14,6,31,12,7,9,10,38,69
Turkey,Europe,2019,5,7,3,15,5,3,3,5,16,31
Turkmenistan,Eurasia,2019,0,0,0,0,0,0,0,2,2,2
Tuvalu,Asia,2019,12,15,10,37,16,12,15,13,56,93
Uganda,Africa,2019,3,5,3,11,10,4,4,7,25,36
Ukraine,Eurasia,2019,9,11,6,26,11,7,6,10,34,60
United Arab Emirates,Middle East,2019,1,2,2,5,3,2,3,4,12,17
United Kingdom,Europe,2019,12,16,11,39,14,12,14,14,54,93
United States,Americas,2019,10,14,9,33,16,11,11,15,53,86
Uruguay,Americas,2019,12,16,12,40,16,12,15,15,58,98
Uzbekistan,Eurasia,2019,0,0,1,1,2,1,1,4,8,9
Vanuatu,Asia,2019,10,15,8,33,15,11,12,11,49,82
Venezuela,Americas,2019,0,3,0,3,7,2,1,6,16,19
Vietnam,Asia,2019,0,1,2,3,4,1,4,8,17,20
Yemen,Middle East,2019,0,1,0,1,3,3,2,2,10,11
Zambia,Africa,2019,6,10,6,22,9,7,8,8,32,54
Zimbabwe,Africa,2019,3,6,3,12,8,4,2,5,19,31
Afghanistan,Asia,2018,2,7,3,12,6,4,2,2,14,26
Albania,Europe,2018,8,13,7,28,13,9,9,9,40,68
Algeria,Africa,2018,3,4,3,10,7,5,6,7,25,35
Andorra,Europe,2018,12,15,12,39,15,11,15,16,57,96
Angola,Africa,2018,3,6,1,10,7,3,3,3,16,26
Antigua and Barbuda,Americas,2018,12,13,8,33,15,9,13,13,50,83
Argentina,Americas,2018,11,14,8,33,15,11,10,14,50,83
Armenia,Eurasia,2018,4,7,4,15,9,6,6,9,30,45
Australia,Asia,2018,12,16,12,40,16,12,15,15,58,98
Austria,Europe,2018,12,15,10,37,15,12,15,15,57,94
Azerbaijan,Eurasia,2018,1,2,0,3,2,1,1,5,9,12
Bahamas,Americas,2018,12,16,10,38,15,12,13,13,53,91
Bahrain,Middle East,2018,2,3,3,2,2,1,1,6,10,12
Bangladesh,Asia,2018,7,7,5,19,7,5,5,9,26,45
Barbados,Americas,2018,12,16,10,38,16,12,15,15,58,96
Belarus,Eurasia,2018,0,4,2,6,3,3,2,7,15,21
Belgium,Europe,2018,12,16,11,39,15,12,14,15,56,95
Belize,Americas,2018,12,14,10,36,15,10,12,13,50,86
Benin,Africa,2018,9,16,8,33,15,12,12,10,49,82
Bhutan,Asia,2018,10,11,9,28,9,4,6,8,27,55
Bolivia,Americas,2018,10,11,7,28,14,9,6,10,39,67
Bosnia and Herzegovina,Europe,2018,7,10,4,21,10,7,7,10,34,55
Botswana,Africa,2018,10,10,8,28,12,10,11,11,44,72
Brazil,Americas,2018,11,14,6,31,15,10,9,13,47,78
Brunei,Asia,2018,0,3,3,6,6,3,6,7,22,28
Bulgaria,Europe,2018,11,14,8,33,14,11,10,12,47,80
Burkina Faso,Africa,2018,7,10,6,23,13,9,7,8,37,60
Burundi,Africa,2018,1,3,0,4,6,2,1,5,14,18
Cabo Verde,Africa,2018,12,15,10,37,15,11,14,13,53,90
Cambodia,Asia,2018,4,3,3,10,8,3,3,6,20,30
Cameroon,Africa,2018,3,3,3,9,6,2,1,4,13,22
Canada,Americas,2018,12,16,12,40,16,12,15,16,59,99
Central African Republic,Africa,2018,3,3,0,4,4,1,0,0,5,9
Chad,Africa,2018,2,1,1,4,6,4,1,3,14,18
Chile,Americas,2018,12,15,10,37,16,12,14,15,57,94
China,Asia,2018,0,2,2,0,3,3,2,6,14,14
Colombia,Americas,2018,10,11,8,29,12,5,9,10,36,65
Comoros,Africa,2018,9,11,4,24,10,7,8,6,31,55
Congo (Brazzaville),Africa,2018,0,2,0,2,7,5,1,6,19,21
Congo (Kinshasa),Africa,2018,0,3,1,4,7,2,0,4,13,17
Costa Rica,Americas,2018,12,15,11,38,16,11,13,13,53,91
"Cote d'Ivoire",Africa,2018,7,8,4,19,11,8,6,7,32,51
Croatia,Europe,2018,12,15,10,37,13,12,11,13,49,86
Cuba,Americas,2018,0,0,1,1,5,0,2,6,13,14
Cyprus,Europe,2018,11,16,11,38,15,12,15,14,56,94
Czech Republic,Europe,2018,12,15,10,37,15,12,14,15,56,93
Denmark,Europe,2018,12,16,12,40,16,12,14,15,57,97
Djibouti,Africa,2018,2,3,2,7,6,3,4,6,19,26
Dominica,Americas,2018,11,16,10,37,15,11,15,15,56,93
Dominican Republic,Americas,2018,9,10,7,26,14,10,8,9,41,67
Ecuador,Americas,2018,7,11,7,25,12,7,6,10,35,60
Egypt,Africa,2018,3,4,3,10,5,2,3,6,16,26
El Salvador,Americas,2018,11,14,9,34,12,8,8,8,36,70
Equatorial Guinea,Africa,2018,0,1,0,1,3,0,0,3,6,7
Eritrea,Africa,2018,0,0,1,1,0,0,0,2,2,3
Estonia,Europe,2018,12,15,11,38,16,12,14,14,56,94
Eswatini,Africa,2018,0,1,0,1,5,2,4,4,15,16
Ethiopia,Africa,2018,1,0,3,4,2,0,2,4,8,12
Fiji,Asia,2018,8,9,7,24,12,6,7,10,35,59
Finland,Europe,2018,12,16,12,40,16,12,16,16,60,100
France,Europe,2018,12,15,11,38,14,11,13,14,52,90
Gabon,Africa,2018,0,2,2,4,8,3,3,5,19,23
Georgia,Eurasia,2018,9,10,7,26,11,8,8,11,38,64
Germany,Europe,2018,12,15,12,39,14,12,14,15,55,94
Ghana,Africa,2018,12,15,10,37,14,11,11,10,46,83
Greece,Europe,2018,12,15,8,35,14,12,11,13,50,85
Grenada,Americas,2018,11,16,10,37,15,11,12,13,51,88
Guatemala,Americas,2018,8,10,5,23,12,6,7,8,33,56
Guinea,Africa,2018,6,8,3,17,10,5,4,5,24,41
Guinea-Bissau,Africa,2018,7,8,1,16,10,6,4,5,25,41
Guyana,Americas,2018,11,13,8,32,15,10,8,9,42,74
Haiti,Americas,2018,5,7,5,17,10,4,4,6,24,41
Honduras,Americas,2018,7,8,5,20,9,4,5,8,26,46
Hungary,Europe,2018,9,12,7,28,11,10,10,13,44,72
Iceland,Europe,2018,12,15,10,37,15,12,15,16,58,95
India,Asia,2018,12,14,9,35,13,10,9,10,42,77
Indonesia,Asia,2018,11,13,6,30,12,8,5,9,34,64
Iran,Middle East,2018,3,2,2,7,3,1,3,4,11,18
Iraq,Middle East,2018,8,8,2,16,5,6,0,4,15,31
Ireland,Europe,2018,12,16,11,39,16,12,14,15,57,96
Israel,Middle East,2018,12,14,10,36,12,9,11,11,43,79
Italy,Europe,2018,12,14,10,36,15,12,12,14,53,89
Jamaica,Americas,2018,12,13,9,34,15,9,8,11,43,77
Japan,Asia,2018,12,16,12,40,15,12,15,14,56,96
Jordan,Middle East,2018,3,6,3,12,7,3,7,8,25,37
Kazakhstan,Eurasia,2018,1,3,1,5,4,1,4,8,17,22
Kenya,Africa,2018,6,8,5,19,10,7,5,7,29,48
Kiribati,Asia,2018,12,16,10,38,15,12,15,13,55,93
Kosovo,Europe,2018,9,10,5,24,9,6,6,7,28,52
Kuwait,Middle East,2018,2,7,4,13,6,4,7,6,23,36
Kyrgyzstan,Eurasia,2018,4,6,4,12,10,4,4,7,25,37
Laos,Asia,2018,0,0,1,1,4,0,2,5,11,12
Latvia,Europe,2018,12,14,9,35,15,12,12,13,52,87
Lebanon,Middle East,2018,3,7,1,11,12,8,5,7,32,43
Lesotho,Africa,2018,10,11,6,27,12,7,9,9,37,64
Liberia,Africa,2018,8,12,7,27,11,8,7,9,35,62
Libya,Africa,2018,0,1,0,1,4,2,0,2,8,9
Liechtenstein,Europe,2018,10,13,10,33,16,12,14,15,57,90
Lithuania,Europe,2018,12,16,10,38,16,11,12,14,53,91
Luxembourg,Europe,2018,12,16,10,38,16,12,16,16,60,98
Madagascar,Africa,2018,9,10,5,24,10,8,6,8,32,56
Malawi,Africa,2018,8,12,6,26,13,8,9,7,37,63
Malaysia,Asia,2018,6,7,5,18,7,6,5,9,27,45
Maldives,Asia,2018,5,5,4,14,3,5,6,7,21,35
Mali,Africa,2018,6,7,4,17,11,6,6,4,27,44
Malta,Europe,2018,12,14,10,36,15,12,15,14,56,92
Marshall Islands,Asia,2018,12,15,10,37,16,11,15,13,55,92
Mauritania,Africa,2018,3,2,4,9,9,4,4,4,21,30
Mauritius,Africa,2018,12,15,10,37,15,12,13,12,52,89
Mexico,Americas,2018,9,12,5,26,13,7,6,10,36,62
Micronesia,Asia,2018,12,15,10,37,16,11,15,14,56,93
Moldova,Eurasia,2018,10,11,5,26,12,8,6,9,35,61
Monaco,Europe,2018,7,10,8,25,16,12,15,14,57,82
Mongolia,Asia,2018,11,16,9,36,14,11,12,12,49,85
Montenegro,Europe,2018,8,10,7,25,11,9,10,12,42,67
Morocco,Africa,2018,5,6,3,14,7,5,6,7,25,39
Mozambique,Africa,2018,6,9,5,20,9,7,7,9,32,52
Myanmar,Asia,2018,5,12,4,13,6,6,1,5,18,31
Namibia,Africa,2018,10,11,9,30,14,12,11,10,47,77
Nauru,Asia,2018,12,15,8,35,13,9,10,14,46,81
Nepal,Asia,2018,10,10,5,25,10,6,6,8,30,55
Netherlands,Europe,2018,12,16,12,40,16,12,15,16,59,99
New Zealand,Asia,2018,12,16,12,40,16,12,15,15,58,98
Nicaragua,Americas,2018,3,6,3,12,11,5,6,10,32,44
Niger,Africa,2018,6,8,6,20,11,6,6,6,29,49
Nigeria,Africa,2018,9,10,6,25,9,7,4,5,25,50
North Korea,Asia,2018,0,0,0,0,0,0,0,3,3,3
North Macedonia,Europe,2018,6,9,6,21,11,8,8,10,37,58
Norway,Europe,2018,12,16,12,40,16,12,16,16,60,100
Oman,Middle East,2018,2,2,2,6,5,3,4,5,17,23
Pakistan,Asia,2018,6,8,5,19,7,6,5,6,24,43
Palau,Asia,2018,12,15,10,37,16,11,15,13,55,92
Panama,Americas,2018,12,15,8,35,15,11,10,12,48,83
Papua New Guinea,Asia,2018,8,13,4,25,13,9,7,9,38,63
Paraguay,Americas,2018,10,12,5,27,12,8,7,10,37,64
Peru,Americas,2018,11,13,7,31,15,8,8,11,42,73
Philippines,Asia,2018,9,11,7,27,14,8,3,10,35,62
Poland,Europe,2018,12,16,8,36,14,10,11,14,49,85
Portugal,Europe,2018,12,16,11,39,16,12,15,15,58,97
Qatar,Middle East,2018,2,2,3,7,7,2,4,4,17,24
Romania,Europe,2018,11,14,10,35,14,11,12,12,49,84
Russia,Eurasia,2018,0,3,2,5,3,3,2,7,15,20
Rwanda,Africa,2018,2,1,5,8,4,2,2,7,15,23
Samoa,Asia,2018,9,12,9,30,14,10,14,12,50,80
San Marino,Europe,2018,12,15,11,38,15,12,16,16,59,97
Sao Tome and Principe,Africa,2018,11,14,9,34,15,10,12,11,48,82
Saudi Arabia,Middle East,2018,0,1,1,0,3,0,2,2,7,7
Senegal,Africa,2018,10,13,8,31,13,10,10,11,44,75
Serbia,Europe,2018,9,12,7,28,13,10,9,13,45,73
Seychelles,Africa,2018,10,11,7,28,12,9,11,11,43,71
Sierra Leone,Africa,2018,10,11,7,28,12,7,9,10,38,66
Singapore,Asia,2018,4,8,7,19,10,4,7,12,33,52
Slovakia,Europe,2018,12,15,9,36,15,12,12,14,53,89
Slovenia,Europe,2018,12,16,11,39,14,12,14,14,54,93
Solomon Islands,Asia,2018,9,13,6,28,14,9,9,12,44,72
Somalia,Africa,2018,0,1,0,1,3,2,0,1,6,7
South Africa,Africa,2018,12,13,7,32,15,12,9,10,46,78
South Korea,Asia,2018,11,13,9,33,14,11,13,13,51,84
South Sudan,Africa,2018,1,5,0,-2,2,2,0,0,4,2
Spain,Europe,2018,11,16,11,38,15,11,15,15,56,94
Sri Lanka,Asia,2018,8,11,7,24,8,8,7,8,31,55
St. Kitts and Nevis,Americas,2018,10,16,10,36,15,12,13,13,53,89
St. Lucia,Americas,2018,11,16,11,38,15,12,12,14,53,91
St. Vincent and the Grenadines,Americas,2018,11,15,10,36,15,12,13,14,54,90
Sudan,Africa,2018,2,7,1,4,2,1,0,1,4,8
Suriname,Americas,2018,12,14,8,34,15,11,8,10,44,78
Sweden,Europe,2018,12,16,12,40,16,12,16,16,60,100
Switzerland,Europe,2018,12,15,12,39,15,12,15,15,57,96
Syria,Middle East,2018,0,3,0,-3,2,0,0,0,2,-1
Taiwan,Asia,2018,12,15,10,37,16,11,15,14,56,93
Tajikistan,Eurasia,2018,0,0,1,1,2,2,2,4,10,11
Tanzania,Africa,2018,7,9,6,22,7,6,8,9,30,52
Thailand,Asia,2018,0,3,3,6,6,4,5,10,25,31
The Gambia,Africa,2018,7,9,4,20,7,5,3,6,21,41
Timor-Leste,Asia,2018,11,14,7,32,13,8,7,9,37,69
Togo,Africa,2018,6,7,5,18,9,6,7,7,29,47
Tonga,Asia,2018,9,14,7,30,12,9,12,12,45,75
Trinidad and Tobago,Americas,2018,11,13,9,33,15,11,9,13,48,81
Tunisia,Africa,2018,10,14,6,30,12,9,9,10,40,70
Turkey,Europe,2018,6,7,3,16,5,3,2,6,16,32
Turkmenistan,Eurasia,2018,0,0,0,0,1,0,0,3,4,4
Tuvalu,Asia,2018,12,15,10,37,16,12,15,14,57,94
Uganda,Africa,2018,3,5,3,11,11,4,4,7,26,37
Ukraine,Eurasia,2018,9,11,6,26,11,9,6,10,36,62
United Arab Emirates,Middle East,2018,1,2,2,5,3,2,3,4,12,17
United Kingdom,Europe,2018,12,16,12,40,14,12,14,14,54,94
United States,Americas,2018,10,14,9,33,16,10,12,15,53,86
Uruguay,Americas,2018,12,16,12,40,16,12,15,15,58,98
Uzbekistan,Eurasia,2018,0,0,1,1,1,1,0,4,6,7
Vanuatu,Asia,2018,10,15,8,33,15,11,11,11,48,81
Venezuela,Americas,2018,2,6,0,8,8,2,1,7,18,26
Vietnam,Asia,2018,0,1,2,3,4,1,4,8,17,20
Yemen,Middle East,2018,0,1,0,1,5,3,2,2,12,13
Zambia,Africa,2018,6,10,6,22,10,7,8,8,33,55
Zimbabwe,Africa,2018,2,6,2,10,8,4,3,5,20,30
Afghanistan,Asia,2017,2,6,2,10,6,4,2,2,14,24
Albania,Europe,2017,8,13,7,28,13,9,9,9,40,68
Algeria,Africa,2017,4,4,3,11,7,5,5,7,24,35
Andorra,Europe,2017,12,15,12,39,15,11,15,15,56,95
Angola,Africa,2017,3,6,1,10,5,3,3,3,14,24
Antigua and Barbuda,Americas,2017,12,13,8,33,15,9,13,13,50,83
Argentina,Americas,2017,11,14,8,33,14,11,10,14,49,82
Armenia,Eurasia,2017,5,7,4,16,9,6,5,9,29,45
Australia,Asia,2017,12,16,12,40,16,12,15,15,58,98
Austria,Europe,2017,12,15,10,37,16,12,15,15,58,95
Azerbaijan,Eurasia,2017,1,2,1,4,2,1,2,5,10,14
Bahamas,Americas,2017,12,16,10,38,15,12,13,13,53,91
Bahrain,Middle East,2017,2,3,3,2,2,1,1,6,10,12
Bangladesh,Asia,2017,7,8,5,20,7,6,5,9,27,47
Barbados,Americas,2017,12,16,12,40,16,12,15,15,58,98
Belarus,Eurasia,2017,0,4,1,5,3,3,2,7,15,20
Belgium,Europe,2017,12,16,12,40,15,12,13,15,55,95
Belize,Americas,2017,12,14,10,36,15,11,12,13,51,87
Benin,Africa,2017,9,16,8,33,15,12,12,10,49,82
Bhutan,Asia,2017,10,11,9,28,9,4,6,8,27,55
Bolivia,Americas,2017,11,11,7,29,14,9,6,10,39,68
Bosnia and Herzegovina,Europe,2017,7,10,4,21,10,7,7,10,34,55
Botswana,Africa,2017,10,10,8,28,12,10,11,11,44,72
Brazil,Americas,2017,11,14,6,31,15,10,10,13,48,79
Brunei,Asia,2017,0,3,3,7,6,3,6,7,22,29
Bulgaria,Europe,2017,11,14,8,33,14,11,10,12,47,80
Burkina Faso,Africa,2017,7,10,6,23,14,9,8,9,40,63
Burundi,Africa,2017,1,4,0,5,6,2,1,5,14,19
Cabo Verde,Africa,2017,12,15,10,37,15,11,14,13,53,90
Cambodia,Asia,2017,4,4,3,11,8,3,3,6,20,31
Cameroon,Africa,2017,3,3,3,9,7,3,1,4,15,24
Canada,Americas,2017,12,16,12,40,16,12,15,16,59,99
Central African Republic,Africa,2017,3,3,0,4,4,1,0,1,6,10
Chad,Africa,2017,2,1,1,4,6,4,1,3,14,18
Chile,Americas,2017,12,15,10,37,16,12,14,15,57,94
China,Asia,2017,0,3,2,1,3,3,2,6,14,15
Colombia,Americas,2017,10,11,8,29,12,5,8,10,35,64
Comoros,Africa,2017,9,11,4,24,10,7,8,6,31,55
Congo (Brazzaville),Africa,2017,1,2,2,5,7,6,2,7,22,27
Congo (Kinshasa),Africa,2017,0,3,1,4,8,3,0,4,15,19
Costa Rica,Americas,2017,12,15,11,38,16,11,13,13,53,91
"Cote d'Ivoire",Africa,2017,7,8,5,20,11,8,6,7,32,52
Croatia,Europe,2017,12,15,10,37,14,12,11,13,50,87
Cuba,Americas,2017,0,0,1,1,5,0,3,6,14,15
Cyprus,Europe,2017,11,16,11,38,15,12,15,14,56,94
Czech Republic,Europe,2017,12,15,11,38,15,12,14,15,56,94
Denmark,Europe,2017,12,16,12,40,16,12,14,15,57,97
Djibouti,Africa,2017,2,3,2,7,6,3,4,6,19,26
Dominica,Americas,2017,12,16,10,38,15,12,15,15,57,95
Dominican Republic,Americas,2017,9,10,8,27,14,10,8,9,41,68
Ecuador,Americas,2017,7,11,6,24,11,6,6,10,33,57
Egypt,Africa,2017,3,4,2,9,5,4,2,6,17,26
El Salvador,Americas,2017,11,14,9,34,12,8,8,8,36,70
Equatorial Guinea,Africa,2017,0,1,0,1,4,0,0,3,7,8
Eritrea,Africa,2017,0,0,1,1,0,0,0,2,2,3
Estonia,Europe,2017,12,15,11,38,16,12,14,14,56,94
Eswatini,Africa,2017,0,1,0,1,7,2,4,4,17,18
Ethiopia,Africa,2017,1,0,3,4,2,0,2,4,8,12
Fiji,Asia,2017,8,10,7,25,12,5,7,10,34,59
Finland,Europe,2017,12,16,12,40,16,12,16,16,60,100
France,Europe,2017,12,15,11,38,14,11,13,14,52,90
Gabon,Africa,2017,2,3,3,8,9,4,6,5,24,32
Georgia,Eurasia,2017,9,11,7,27,11,8,8,10,37,64
Germany,Europe,2017,12,15,12,39,15,12,14,15,56,95
Ghana,Africa,2017,12,15,10,37,14,11,11,10,46,83
Greece,Europe,2017,12,15,8,35,14,11,11,13,49,84
Grenada,Americas,2017,12,16,10,38,15,11,12,13,51,89
Guatemala,Americas,2017,8,10,5,23,11,6,6,8,31,54
Guinea,Africa,2017,6,8,3,17,10,5,4,5,24,41
Guinea-Bissau,Africa,2017,7,8,1,16,10,5,4,5,24,40
Guyana,Americas,2017,11,13,8,32,15,10,8,9,42,74
Haiti,Americas,2017,3,8,4,15,10,4,4,6,24,39
Honduras,Americas,2017,7,8,4,19,9,5,5,8,27,46
Hungary,Europe,2017,9,13,7,29,13,11,10,13,47,76
Iceland,Europe,2017,12,16,10,38,16,12,15,16,59,97
India,Asia,2017,12,14,9,35,13,10,9,10,42,77
Indonesia,Asia,2017,11,14,6,31,12,8,5,9,34,65
Iran,Middle East,2017,3,2,2,7,2,1,3,4,10,17
Iraq,Middle East,2017,8,8,2,12,5,6,0,4,15,27
Ireland,Europe,2017,12,16,11,39,16,12,14,15,57,96
Israel,Middle East,2017,12,14,10,36,12,10,11,11,44,80
Italy,Europe,2017,12,14,10,36,15,12,12,14,53,89
Jamaica,Americas,2017,12,13,9,34,15,9,7,10,41,75
Japan,Asia,2017,12,16,12,40,15,12,15,14,56,96
Jordan,Middle East,2017,3,6,3,12,7,4,6,8,25,37
Kazakhstan,Eurasia,2017,1,3,1,5,4,1,4,8,17,22
Kenya,Africa,2017,7,10,5,22,10,7,5,7,29,51
Kiribati,Asia,2017,12,16,9,37,15,12,15,13,55,92
Kosovo,Europe,2017,9,10,5,24,9,6,6,7,28,52
Kuwait,Middle East,2017,2,7,4,13,6,4,7,6,23,36
Kyrgyzstan,Eurasia,2017,5,8,4,13,9,4,4,7,24,37
Laos,Asia,2017,0,0,1,1,4,0,2,5,11,12
Latvia,Europe,2017,12,15,9,36,15,12,12,12,51,87
Lebanon,Middle East,2017,3,9,2,14,11,7,5,7,30,44
Lesotho,Africa,2017,10,11,6,27,12,7,9,9,37,64
Liberia,Africa,2017,9,12,7,28,11,8,7,8,34,62
Libya,Africa,2017,1,2,0,3,4,2,0,4,10,13
Liechtenstein,Europe,2017,10,13,10,33,16,12,14,16,58,91
Lithuania,Europe,2017,12,16,10,38,16,11,13,13,53,91
Luxembourg,Europe,2017,12,16,10,38,16,12,16,16,60,98
Madagascar,Africa,2017,9,10,5,24,10,8,6,8,32,56
Malawi,Africa,2017,8,12,6,26,13,8,9,7,37,63
Malaysia,Asia,2017,6,7,5,18,7,5,5,9,26,44
Maldives,Asia,2017,7,5,5,17,5,5,6,7,23,40
Mali,Africa,2017,6,7,4,17,12,6,6,4,28,45
Malta,Europe,2017,12,16,11,39,16,12,15,14,57,96
Marshall Islands,Asia,2017,12,15,10,37,16,11,15,13,55,92
Mauritania,Africa,2017,3,2,4,9,9,4,4,4,21,30
Mauritius,Africa,2017,12,15,10,37,15,12,13,12,52,89
Mexico,Americas,2017,9,12,7,28,13,8,6,10,37,65
Micronesia,Asia,2017,12,15,10,37,16,11,15,14,56,93
Moldova,Eurasia,2017,10,12,5,27,12,8,6,9,35,62
Monaco,Europe,2017,7,11,9,27,16,12,15,14,57,84
Mongolia,Asia,2017,11,16,9,36,14,11,12,12,49,85
Montenegro,Europe,2017,8,11,7,26,12,9,10,12,43,69
Morocco,Africa,2017,5,7,3,15,7,6,6,7,26,41
Mozambique,Africa,2017,6,9,5,20,11,7,7,8,33,53
Myanmar,Asia,2017,5,11,4,14,7,5,1,5,18,32
Namibia,Africa,2017,10,11,9,30,14,12,11,10,47,77
Nauru,Asia,2017,12,15,8,35,13,9,10,14,46,81
Nepal,Asia,2017,9,10,5,24,9,5,6,8,28,52
Netherlands,Europe,2017,12,16,12,40,16,12,15,16,59,99
New Zealand,Asia,2017,12,16,12,40,16,12,15,15,58,98
Nicaragua,Americas,2017,3,6,5,14,11,5,7,10,33,47
Niger,Africa,2017,6,9,6,21,11,6,5,6,28,49
Nigeria,Africa,2017,9,10,6,25,9,7,4,5,25,50
North Korea,Asia,2017,0,0,0,0,0,0,0,3,3,3
North Macedonia,Europe,2017,6,10,5,21,10,8,8,10,36,57
Norway,Europe,2017,12,16,12,40,16,12,16,16,60,100
Oman,Middle East,2017,2,2,2,8,5,3,4,5,17,25
Pakistan,Asia,2017,7,8,6,21,6,6,4,6,22,43
Palau,Asia,2017,12,15,10,37,16,11,15,13,55,92
Panama,Americas,2017,12,15,8,35,15,11,10,12,48,83
Papua New Guinea,Asia,2017,9,13,4,26,13,9,7,9,38,64
Paraguay,Americas,2017,10,12,5,27,12,8,7,10,37,64
Peru,Americas,2017,11,13,7,31,15,8,8,10,41,72
Philippines,Asia,2017,9,11,7,27,14,8,4,10,36,63
Poland,Europe,2017,12,16,9,37,14,12,12,14,52,89
Portugal,Europe,2017,12,16,11,39,16,12,15,15,58,97
Qatar,Middle East,2017,2,2,3,9,7,2,4,4,17,26
Romania,Europe,2017,11,14,10,35,14,11,12,12,49,84
Russia,Eurasia,2017,0,3,2,5,3,3,2,7,15,20
Rwanda,Africa,2017,2,1,5,8,4,2,3,7,16,24
Samoa,Asia,2017,9,12,9,30,14,10,14,12,50,80
San Marino,Europe,2017,12,15,11,38,15,12,16,16,59,97
Sao Tome and Principe,Africa,2017,11,14,9,34,15,10,12,10,47,81
Saudi Arabia,Middle East,2017,0,0,1,3,3,0,2,2,7,10
Senegal,Africa,2017,11,13,8,32,15,10,10,11,46,78
Serbia,Europe,2017,9,13,7,29,14,10,10,13,47,76
Seychelles,Africa,2017,10,11,7,28,12,9,11,11,43,71
Sierra Leone,Africa,2017,10,11,7,28,12,7,9,10,38,66
Singapore,Asia,2017,4,8,7,19,9,4,7,12,32,51
Slovakia,Europe,2017,12,15,9,36,15,12,12,14,53,89
Slovenia,Europe,2017,12,16,11,39,14,12,14,13,53,92
Solomon Islands,Asia,2017,9,13,5,27,14,9,9,12,44,71
Somalia,Africa,2017,0,0,0,0,3,1,0,1,5,5
South Africa,Africa,2017,12,14,7,33,15,11,9,10,45,78
South Korea,Asia,2017,11,13,8,32,13,11,13,13,50,82
South Sudan,Africa,2017,1,5,0,-2,4,2,0,0,6,4
Spain,Europe,2017,12,16,10,38,15,11,15,15,56,94
Sri Lanka,Asia,2017,8,11,7,24,9,8,7,8,32,56
St. Kitts and Nevis,Americas,2017,10,16,10,36,15,12,13,13,53,89
St. Lucia,Americas,2017,12,16,11,39,15,12,12,14,53,92
St. Vincent and the Grenadines,Americas,2017,11,16,10,37,15,12,13,14,54,91
Sudan,Africa,2017,2,7,1,2,2,1,0,1,4,6
Suriname,Americas,2017,12,14,8,34,15,11,7,10,43,77
Sweden,Europe,2017,12,16,12,40,16,12,16,16,60,100
Switzerland,Europe,2017,12,15,12,39,15,12,15,15,57,96
Syria,Middle East,2017,0,3,0,-3,2,0,0,0,2,-1
Taiwan,Asia,2017,12,15,10,37,16,11,14,13,54,91
Tajikistan,Eurasia,2017,0,0,1,1,2,2,2,4,10,11
Tanzania,Africa,2017,7,11,7,25,9,6,9,9,33,58
Thailand,Asia,2017,1,3,3,7,6,4,5,10,25,32
The Gambia,Africa,2017,3,5,0,8,3,2,1,6,12,20
Timor-Leste,Asia,2017,11,12,6,29,12,8,7,9,36,65
Togo,Africa,2017,6,7,5,18,9,7,7,7,30,48
Tonga,Asia,2017,9,14,7,30,12,9,11,12,44,74
Trinidad and Tobago,Americas,2017,11,13,9,33,15,11,9,13,48,81
Tunisia,Africa,2017,11,16,9,36,13,9,9,11,42,78
Turkey,Europe,2017,8,7,3,18,6,3,4,7,20,38
Turkmenistan,Eurasia,2017,0,0,0,0,1,0,0,3,4,4
Tuvalu,Asia,2017,12,15,10,37,16,12,15,14,57,94
Uganda,Africa,2017,3,5,3,11,9,4,4,7,24,35
Ukraine,Eurasia,2017,9,10,6,25,11,9,6,10,36,61
United Arab Emirates,Middle East,2017,1,2,2,7,4,2,3,4,13,20
United Kingdom,Europe,2017,12,16,12,40,14,12,14,15,55,95
United States,Americas,2017,11,14,11,36,16,10,12,15,53,89
Uruguay,Americas,2017,12,16,12,40,16,12,15,15,58,98
Uzbekistan,Eurasia,2017,0,0,0,0,0,0,0,3,3,3
Vanuatu,Asia,2017,10,15,7,32,15,11,11,11,48,80
Venezuela,Americas,2017,5,6,0,11,8,3,1,7,19,30
Vietnam,Asia,2017,0,1,2,3,4,1,4,8,17,20
Yemen,Middle East,2017,0,1,1,2,5,3,2,2,12,14
Zambia,Africa,2017,6,11,6,23,10,7,8,8,33,56
Zimbabwe,Africa,2017,3,6,3,12,8,4,3,5,20,32
Afghanistan,Asia,2016,2,6,2,10,6,4,2,2,14,24
Albania,Europe,2016,8,13,6,27,13,9,9,9,40,67
Algeria,Africa,2016,4,4,3,11,7,5,5,7,24,35
Andorra,Europe,2016,12,15,12,39,16,11,15,15,57,96
Angola,Africa,2016,3,6,1,10,5,3,3,3,14,24
Antigua and Barbuda,Americas,2016,12,13,8,33,14,9,13,13,49,82
Argentina,Americas,2016,11,14,6,31,14,11,10,13,48,79
Armenia,Eurasia,2016,5,7,4,16,9,6,6,9,30,46
Australia,Asia,2016,12,16,12,40,16,12,15,15,58,98
Austria,Europe,2016,12,15,10,37,16,12,15,15,58,95
Azerbaijan,Eurasia,2016,1,3,1,5,3,1,2,5,11,16
Bahamas,Americas,2016,12,16,10,38,16,12,13,13,54,92
Bahrain,Middle East,2016,2,5,3,4,2,1,1,6,10,14
Bangladesh,Asia,2016,7,9,5,21,7,6,6,9,28,49
Barbados,Americas,2016,12,16,12,40,16,12,15,15,58,98
Belarus,Eurasia,2016,0,3,1,4,3,1,2,7,13,17
Belgium,Europe,2016,12,16,12,40,15,12,14,15,56,96
Belize,Americas,2016,12,14,10,36,15,11,12,13,51,87
Benin,Africa,2016,9,16,8,33,15,12,12,10,49,82
Bhutan,Asia,2016,10,11,10,29,9,4,6,8,27,56
Bolivia,Americas,2016,11,11,7,29,14,9,6,10,39,68
Bosnia and Herzegovina,Europe,2016,8,10,4,22,10,7,8,10,35,57
Botswana,Africa,2016,10,10,8,28,12,10,12,11,45,73
Brazil,Americas,2016,11,14,8,33,15,10,10,13,48,81
Brunei,Asia,2016,0,3,3,7,6,3,6,7,22,29
Bulgaria,Europe,2016,11,14,8,33,14,11,10,12,47,80
Burkina Faso,Africa,2016,6,9,6,21,14,8,8,8,38,59
Burundi,Africa,2016,1,4,0,5,6,2,1,5,14,19
Cabo Verde,Africa,2016,12,15,10,37,15,11,14,13,53,90
Cambodia,Asia,2016,4,4,3,11,9,3,3,6,21,32
Cameroon,Africa,2016,3,3,3,9,7,3,1,4,15,24
Canada,Americas,2016,12,16,12,40,16,12,15,16,59,99
Central African Republic,Africa,2016,1,2,0,1,4,1,0,1,6,7
Chad,Africa,2016,2,1,1,4,7,5,1,3,16,20
Chile,Americas,2016,12,15,11,38,16,12,14,15,57,95
China,Asia,2016,0,3,2,1,4,3,2,6,15,16
Colombia,Americas,2016,10,11,8,29,12,5,7,10,34,63
Comoros,Africa,2016,9,11,4,24,10,7,8,6,31,55
Congo (Brazzaville),Africa,2016,1,2,3,6,7,6,2,7,22,28
Congo (Kinshasa),Africa,2016,3,4,2,9,8,3,0,5,16,25
Costa Rica,Americas,2016,12,15,10,37,16,11,13,13,53,90
"Cote d'Ivoire",Africa,2016,7,8,5,20,11,7,6,7,31,51
Croatia,Europe,2016,12,15,10,37,14,12,11,13,50,87
Cuba,Americas,2016,0,0,1,1,5,0,3,6,14,15
Cyprus,Europe,2016,11,16,11,38,15,12,15,14,56,94
Czech Republic,Europe,2016,12,15,11,38,16,12,14,15,57,95
Denmark,Europe,2016,12,16,12,40,16,12,15,15,58,98
Djibouti,Africa,2016,3,3,3,9,6,3,4,6,19,28
Dominica,Americas,2016,12,16,10,38,15,12,15,15,57,95
Dominican Republic,Americas,2016,10,10,9,29,14,10,8,9,41,70
Ecuador,Americas,2016,7,11,6,24,12,7,6,10,35,59
Egypt,Africa,2016,3,4,2,9,5,4,2,7,18,27
El Salvador,Americas,2016,10,14,9,33,12,8,8,8,36,69
Equatorial Guinea,Africa,2016,0,1,0,1,4,0,0,3,7,8
Eritrea,Africa,2016,0,0,1,1,0,0,0,2,2,3
Estonia,Europe,2016,12,15,11,38,16,12,14,14,56,94
Eswatini,Africa,2016,0,1,0,1,7,2,4,4,17,18
Ethiopia,Africa,2016,1,0,3,4,3,0,3,5,11,15
Fiji,Asia,2016,9,11,7,27,11,5,9,10,35,62
Finland,Europe,2016,12,16,12,40,16,12,16,16,60,100
France,Europe,2016,12,15,11,38,14,11,13,15,53,91
Gabon,Africa,2016,2,4,3,9,10,4,6,5,25,34
Georgia,Eurasia,2016,9,11,7,27,11,8,8,10,37,64
Germany,Europe,2016,12,15,12,39,15,12,14,15,56,95
Ghana,Africa,2016,12,15,10,37,14,11,11,10,46,83
Greece,Europe,2016,12,15,8,35,14,11,10,13,48,83
Grenada,Americas,2016,12,16,10,38,15,11,12,13,51,89
Guatemala,Americas,2016,8,10,5,23,12,6,5,8,31,54
Guinea,Africa,2016,6,8,3,17,9,5,4,5,23,40
Guinea-Bissau,Africa,2016,7,8,1,16,10,5,3,5,23,39
Guyana,Americas,2016,11,13,8,32,15,10,8,9,42,74
Haiti,Americas,2016,4,8,5,17,10,4,4,6,24,41
Honduras,Americas,2016,7,9,3,19,9,5,4,8,26,45
Hungary,Europe,2016,9,15,8,32,13,11,10,13,47,79
Iceland,Europe,2016,12,16,12,40,16,12,16,16,60,100
India,Asia,2016,12,14,9,35,13,10,9,10,42,77
Indonesia,Asia,2016,11,14,6,31,12,8,5,9,34,65
Iran,Middle East,2016,3,2,2,7,2,1,3,4,10,17
Iraq,Middle East,2016,8,8,2,12,5,6,0,4,15,27
Ireland,Europe,2016,12,16,11,39,16,12,14,15,57,96
Israel,Middle East,2016,12,14,10,36,12,10,11,11,44,80
Italy,Europe,2016,12,14,10,36,15,12,12,14,53,89
Jamaica,Americas,2016,12,13,9,34,15,9,7,10,41,75
Japan,Asia,2016,12,16,12,40,15,12,15,14,56,96
Jordan,Middle East,2016,2,6,3,11,7,4,6,8,25,36
Kazakhstan,Eurasia,2016,2,3,1,6,4,2,4,8,18,24
Kenya,Africa,2016,7,10,5,22,11,6,5,7,29,51
Kiribati,Asia,2016,12,16,8,36,15,12,15,13,55,91
Kosovo,Europe,2016,9,10,5,24,9,6,6,7,28,52
Kuwait,Middle East,2016,2,7,4,13,6,4,7,6,23,36
Kyrgyzstan,Eurasia,2016,6,8,4,14,9,4,4,7,24,38
Laos,Asia,2016,0,0,1,1,4,0,2,5,11,12
Latvia,Europe,2016,12,14,9,35,15,12,12,12,51,86
Lebanon,Middle East,2016,2,9,2,13,11,7,5,7,30,43
Lesotho,Africa,2016,10,12,6,28,14,7,9,9,39,67
Liberia,Africa,2016,9,12,7,28,10,8,7,8,33,61
Libya,Africa,2016,4,2,0,6,6,3,1,4,14,20
Liechtenstein,Europe,2016,12,15,12,39,16,12,15,16,59,98
Lithuania,Europe,2016,12,16,10,38,16,11,13,13,53,91
Luxembourg,Europe,2016,12,16,10,38,16,12,16,16,60,98
Madagascar,Africa,2016,9,10,5,24,10,8,6,8,32,56
Malawi,Africa,2016,8,12,7,27,13,8,9,7,37,64
Malaysia,Asia,2016,6,7,5,18,7,6,5,9,27,45
Maldives,Asia,2016,7,6,6,19,6,5,6,7,24,43
Mali,Africa,2016,6,7,4,17,12,6,6,4,28,45
Malta,Europe,2016,12,16,11,39,16,12,15,14,57,96
Marshall Islands,Asia,2016,12,15,10,37,16,11,15,13,55,92
Mauritania,Africa,2016,3,2,4,9,9,4,4,4,21,30
Mauritius,Africa,2016,12,15,11,38,15,12,13,12,52,90
Mexico,Americas,2016,9,12,7,28,13,8,6,10,37,65
Micronesia,Asia,2016,12,15,10,37,16,11,15,14,56,93
Moldova,Eurasia,2016,10,11,4,25,11,8,7,9,35,60
Monaco,Europe,2016,10,11,10,31,16,12,15,14,57,88
Mongolia,Asia,2016,11,16,9,36,15,11,12,12,50,86
Montenegro,Europe,2016,9,11,7,27,12,9,10,12,43,70
Morocco,Africa,2016,5,7,3,15,8,5,6,7,26,41
Mozambique,Africa,2016,6,10,6,22,11,7,7,9,34,56
Myanmar,Asia,2016,3,11,3,11,7,4,1,5,17,28
Namibia,Africa,2016,10,11,9,30,14,12,11,10,47,77
Nauru,Asia,2016,12,15,8,35,13,10,12,14,49,84
Nepal,Asia,2016,9,11,5,25,9,5,5,7,26,51
Netherlands,Europe,2016,12,16,12,40,16,12,15,16,59,99
New Zealand,Asia,2016,12,16,12,40,16,12,15,15,58,98
Nicaragua,Americas,2016,6,7,6,19,12,6,7,10,35,54
Niger,Africa,2016,8,9,7,24,11,6,5,6,28,52
Nigeria,Africa,2016,9,11,5,23,9,7,4,5,25,48
North Korea,Asia,2016,0,0,0,0,0,0,0,3,3,3
North Macedonia,Europe,2016,6,10,6,22,10,8,7,10,35,57
Norway,Europe,2016,12,16,12,40,16,12,16,16,60,100
Oman,Middle East,2016,2,2,2,8,5,3,4,5,17,25
Pakistan,Asia,2016,7,8,5,20,5,6,4,6,21,41
Palau,Asia,2016,12,15,10,37,16,11,15,13,55,92
Panama,Americas,2016,12,15,8,35,15,11,10,12,48,83
Papua New Guinea,Asia,2016,9,10,4,23,12,9,7,8,36,59
Paraguay,Americas,2016,10,12,5,27,12,8,7,10,37,64
Peru,Americas,2016,10,13,7,30,15,8,8,10,41,71
Philippines,Asia,2016,9,11,7,27,14,9,5,10,38,65
Poland,Europe,2016,12,16,10,38,16,12,13,14,55,93
Portugal,Europe,2016,12,16,11,39,16,12,15,15,58,97
Qatar,Middle East,2016,2,2,3,9,8,2,4,4,18,27
Romania,Europe,2016,11,14,9,34,14,11,12,12,49,83
Russia,Eurasia,2016,1,3,3,7,3,3,2,7,15,22
Rwanda,Africa,2016,2,1,5,8,4,2,3,7,16,24
Samoa,Asia,2016,9,13,9,31,14,10,13,12,49,80
San Marino,Europe,2016,12,16,12,40,16,12,16,16,60,100
Sao Tome and Principe,Africa,2016,11,14,9,34,15,10,12,10,47,81
Saudi Arabia,Middle East,2016,0,0,1,3,3,0,2,2,7,10
Senegal,Africa,2016,11,13,9,33,15,10,10,10,45,78
Serbia,Europe,2016,10,13,7,30,14,11,10,13,48,78
Seychelles,Africa,2016,9,10,7,26,11,9,11,11,42,68
Sierra Leone,Africa,2016,10,11,7,28,12,7,9,9,37,65
Singapore,Asia,2016,4,8,7,19,9,4,7,12,32,51
Slovakia,Europe,2016,12,15,9,36,15,12,12,14,53,89
Slovenia,Europe,2016,12,16,11,39,14,12,14,13,53,92
Solomon Islands,Asia,2016,9,10,6,25,14,9,8,12,43,68
Somalia,Africa,2016,0,0,0,0,1,0,0,1,2,2
South Africa,Africa,2016,12,13,8,33,15,12,9,10,46,79
South Korea,Asia,2016,11,13,10,34,12,11,13,13,49,83
South Sudan,Africa,2016,3,4,1,2,4,3,1,4,12,14
Spain,Europe,2016,12,16,11,39,15,11,15,15,56,95
Sri Lanka,Asia,2016,8,11,6,23,9,8,7,8,32,55
St. Kitts and Nevis,Americas,2016,10,16,9,35,15,12,13,13,53,88
St. Lucia,Americas,2016,12,16,11,39,15,12,12,14,53,92
St. Vincent and the Grenadines,Americas,2016,11,16,10,37,15,12,13,14,54,91
Sudan,Africa,2016,2,7,1,2,2,1,0,1,4,6
Suriname,Americas,2016,12,14,8,34,15,11,7,10,43,77
Sweden,Europe,2016,12,16,12,40,16,12,16,16,60,100
Switzerland,Europe,2016,12,15,12,39,15,12,15,15,57,96
Syria,Middle East,2016,0,3,0,-3,2,0,0,0,2,-1
Taiwan,Asia,2016,12,15,10,37,14,11,14,13,52,89
Tajikistan,Eurasia,2016,1,0,1,2,4,3,3,4,14,16
Tanzania,Africa,2016,8,12,7,27,9,6,9,9,33,60
Thailand,Asia,2016,1,3,3,7,6,4,5,10,25,32
The Gambia,Africa,2016,1,4,0,5,3,3,1,6,13,18
Timor-Leste,Asia,2016,11,12,6,29,12,8,7,9,36,65
Togo,Africa,2016,6,7,5,18,9,7,7,7,30,48
Tonga,Asia,2016,11,14,6,31,13,8,11,12,44,75
Trinidad and Tobago,Americas,2016,11,13,9,33,15,11,9,13,48,81
Tunisia,Africa,2016,12,16,9,37,13,9,9,11,42,79
Turkey,Europe,2016,9,9,6,24,8,6,6,9,29,53
Turkmenistan,Eurasia,2016,0,0,0,0,1,0,0,3,4,4
Tuvalu,Asia,2016,12,15,10,37,16,12,15,14,57,94
Uganda,Africa,2016,3,5,3,11,9,4,5,7,25,36
Ukraine,Eurasia,2016,9,10,6,25,11,9,6,10,36,61
United Arab Emirates,Middle East,2016,1,2,2,7,4,2,3,4,13,20
United Kingdom,Europe,2016,12,16,12,40,13,12,15,15,55,95
United States,Americas,2016,11,15,10,36,15,11,13,15,54,90
Uruguay,Americas,2016,12,16,12,40,16,12,15,15,58,98
Uzbekistan,Eurasia,2016,0,0,0,0,0,0,0,3,3,3
Vanuatu,Asia,2016,9,15,7,31,15,11,10,11,47,78
Venezuela,Americas,2016,5,8,2,15,8,3,1,8,20,35
Vietnam,Asia,2016,0,1,2,3,4,1,4,8,17,20
Yemen,Middle East,2016,2,1,1,4,5,3,2,3,13,17
Zambia,Africa,2016,8,11,7,26,11,7,8,8,34,60
Zimbabwe,Africa,2016,3,6,3,12,8,4,3,5,20,32
Afghanistan,Asia,2015,3,6,2,11,5,4,2,2,13,24
Albania,Europe,2015,8,13,6,27,13,9,9,9,40,67
Algeria,Africa,2015,4,4,3,11,7,4,5,7,23,34
Andorra,Europe,2015,12,15,12,39,16,11,15,15,57,96
Angola,Africa,2015,3,6,1,10,7,4,4,3,18,28
Antigua and Barbuda,Americas,2015,11,13,7,31,14,9,13,13,49,80
Argentina,Americas,2015,11,14,6,31,14,11,11,13,49,80
Armenia,Eurasia,2015,5,7,4,16,9,6,6,9,30,46
Australia,Asia,2015,12,15,12,39,16,12,15,15,58,97
Austria,Europe,2015,12,15,11,38,16,12,15,15,58,96
Azerbaijan,Eurasia,2015,1,3,2,6,4,1,3,6,14,20
Bahamas,Americas,2015,12,16,10,38,16,12,15,15,58,96
Bahrain,Middle East,2015,2,4,3,5,2,1,1,6,10,15
Bangladesh,Asia,2015,7,9,5,21,8,6,6,9,29,50
Barbados,Americas,2015,12,16,12,40,16,12,16,15,59,99
Belarus,Eurasia,2015,0,3,1,4,3,1,1,5,10,14
Belgium,Europe,2015,12,16,12,40,15,12,15,15,57,97
Belize,Americas,2015,12,14,10,36,15,11,12,13,51,87
Benin,Africa,2015,8,16,8,32,15,12,12,10,49,81
Bhutan,Asia,2015,10,11,10,29,9,4,6,8,27,56
Bolivia,Americas,2015,11,11,7,29,14,9,6,10,39,68
Bosnia and Herzegovina,Europe,2015,8,10,5,23,10,7,10,10,37,60
Botswana,Africa,2015,10,10,8,28,12,10,12,11,45,73
Brazil,Americas,2015,11,14,8,33,15,10,10,13,48,81
Brunei,Asia,2015,0,3,3,7,6,3,6,8,23,30
Bulgaria,Europe,2015,11,14,8,33,14,11,10,11,46,79
Burkina Faso,Africa,2015,2,6,1,9,13,8,7,8,36,45
Burundi,Africa,2015,4,5,2,11,8,3,4,6,21,32
Cabo Verde,Africa,2015,12,15,10,37,15,11,14,13,53,90
Cambodia,Asia,2015,4,4,3,11,9,3,2,6,20,31
Cameroon,Africa,2015,3,3,3,9,7,3,2,4,16,25
Canada,Americas,2015,12,16,11,39,16,12,15,16,59,98
Central African Republic,Africa,2015,0,2,0,0,4,1,0,1,6,6
Chad,Africa,2015,3,1,1,5,7,4,2,3,16,21
Chile,Americas,2015,12,15,12,39,16,11,14,15,56,95
China,Asia,2015,0,2,2,2,4,3,2,6,15,17
Colombia,Americas,2015,10,11,8,29,12,5,7,10,34,63
Comoros,Africa,2015,9,11,5,25,10,6,8,6,30,55
Congo (Brazzaville),Africa,2015,1,3,3,7,8,6,2,7,23,30
Congo (Kinshasa),Africa,2015,3,4,2,9,8,3,0,5,16,25
Costa Rica,Americas,2015,12,15,10,37,16,11,13,13,53,90
"Cote d'Ivoire",Africa,2015,6,7,4,17,10,7,6,6,29,46
Croatia,Europe,2015,12,15,9,36,14,12,11,13,50,86
Cuba,Americas,2015,0,0,1,1,4,0,3,6,13,14
Cyprus,Europe,2015,11,16,10,37,15,12,15,14,56,93
Czech Republic,Europe,2015,12,15,11,38,16,12,14,15,57,95
Denmark,Europe,2015,12,16,12,40,16,12,15,15,58,98
Djibouti,Africa,2015,3,3,3,9,6,3,4,6,19,28
Dominica,Americas,2015,12,16,10,38,15,12,15,15,57,95
Dominican Republic,Americas,2015,10,11,9,30,15,10,8,10,43,73
Ecuador,Americas,2015,7,11,6,24,12,7,6,10,35,59
Egypt,Africa,2015,2,4,2,8,5,4,2,7,18,26
El Salvador,Americas,2015,12,14,9,35,15,8,8,9,40,75
Equatorial Guinea,Africa,2015,0,1,0,1,4,0,0,3,7,8
Eritrea,Africa,2015,0,0,1,1,0,0,0,2,2,3
Estonia,Europe,2015,12,15,12,39,16,12,14,14,56,95
Eswatini,Africa,2015,0,1,0,1,6,2,5,4,17,18
Ethiopia,Africa,2015,1,2,4,7,3,0,3,5,11,18
Fiji,Asia,2015,9,11,6,26,11,4,9,10,34,60
Finland,Europe,2015,12,16,12,40,16,12,16,16,60,100
France,Europe,2015,12,15,11,38,15,12,15,15,57,95
Gabon,Africa,2015,2,4,3,9,10,4,6,5,25,34
Georgia,Eurasia,2015,9,10,7,26,12,8,8,10,38,64
Germany,Europe,2015,12,15,12,39,15,12,15,15,57,96
Ghana,Africa,2015,12,15,10,37,14,11,12,10,47,84
Greece,Europe,2015,12,15,8,35,14,11,10,13,48,83
Grenada,Americas,2015,12,16,10,38,15,11,12,13,51,89
Guatemala,Americas,2015,9,10,5,24,12,6,5,8,31,55
Guinea,Africa,2015,6,8,3,17,9,6,4,5,24,41
Guinea-Bissau,Africa,2015,8,8,1,17,10,5,3,5,23,40
Guyana,Americas,2015,11,13,6,30,15,10,7,9,41,71
Haiti,Americas,2015,4,8,5,17,10,4,4,6,24,41
Honduras,Americas,2015,7,9,4,20,10,6,5,8,29,49
Hungary,Europe,2015,9,15,8,32,14,11,11,14,50,82
Iceland,Europe,2015,12,16,11,39,16,12,16,16,60,99
India,Asia,2015,12,14,9,35,13,11,9,10,43,78
Indonesia,Asia,2015,10,14,6,30,12,8,5,9,34,64
Iran,Middle East,2015,3,2,2,7,2,1,3,4,10,17
Iraq,Middle East,2015,8,8,1,11,5,4,0,4,13,24
Ireland,Europe,2015,12,16,11,39,16,12,15,15,58,97
Israel,Middle East,2015,12,14,10,36,12,10,11,11,44,80
Italy,Europe,2015,12,14,10,36,15,12,12,14,53,89
Jamaica,Americas,2015,12,13,9,34,15,9,6,10,40,74
Japan,Asia,2015,12,15,12,39,15,11,15,14,55,94
Jordan,Middle East,2015,2,6,3,11,7,4,6,8,25,36
Kazakhstan,Eurasia,2015,2,3,1,6,4,2,4,8,18,24
Kenya,Africa,2015,7,10,5,22,11,6,5,7,29,51
Kiribati,Asia,2015,12,16,8,36,15,12,15,13,55,91
Kosovo,Europe,2015,9,10,4,23,9,6,6,8,29,52
Kuwait,Middle East,2015,2,7,5,14,6,4,7,6,23,37
Kyrgyzstan,Eurasia,2015,6,8,4,14,9,4,4,7,24,38
Laos,Asia,2015,0,0,1,1,4,0,2,5,11,12
Latvia,Europe,2015,12,14,8,34,15,12,12,12,51,85
Lebanon,Middle East,2015,2,9,3,14,11,7,5,7,30,44
Lesotho,Africa,2015,10,12,8,30,14,7,11,9,41,71
Liberia,Africa,2015,9,11,6,26,10,7,6,7,30,56
Libya,Africa,2015,5,3,0,8,6,3,1,5,15,23
Liechtenstein,Europe,2015,12,15,12,39,16,12,15,16,59,98
Lithuania,Europe,2015,12,16,10,38,16,11,13,13,53,91
Luxembourg,Europe,2015,12,16,10,38,16,12,16,16,60,98
Madagascar,Africa,2015,9,9,4,22,9,8,6,7,30,52
Malawi,Africa,2015,8,12,7,27,11,7,9,7,34,61
Malaysia,Asia,2015,6,7,6,19,7,6,5,9,27,46
Maldives,Asia,2015,7,7,6,20,6,7,7,8,28,48
Mali,Africa,2015,6,7,4,17,11,6,6,4,27,44
Malta,Europe,2015,12,16,11,39,16,12,15,15,58,97
Marshall Islands,Asia,2015,11,15,10,36,16,11,15,13,55,91
Mauritania,Africa,2015,3,2,4,9,10,4,4,4,22,31
Mauritius,Africa,2015,12,15,11,38,15,12,13,12,52,90
Mexico,Americas,2015,9,12,7,28,12,8,6,10,36,64
Micronesia,Asia,2015,12,15,10,37,16,11,15,14,56,93
Moldova,Eurasia,2015,10,12,6,28,11,8,7,9,35,63
Monaco,Europe,2015,10,11,10,31,16,12,15,14,57,88
Mongolia,Asia,2015,11,16,9,36,15,11,12,12,50,86
Montenegro,Europe,2015,9,11,7,27,12,10,10,12,44,71
Morocco,Africa,2015,5,7,3,15,8,6,6,7,27,42
Mozambique,Africa,2015,6,10,7,23,12,7,7,9,35,58
Myanmar,Asia,2015,3,9,3,9,6,4,1,5,16,25
Namibia,Africa,2015,10,11,9,30,14,12,11,9,46,76
Nauru,Asia,2015,12,16,9,37,14,11,12,14,51,88
Nepal,Asia,2015,8,11,5,24,9,6,5,7,27,51
Netherlands,Europe,2015,12,16,12,40,16,12,15,16,59,99
New Zealand,Asia,2015,12,15,12,39,16,12,15,15,58,97
Nicaragua,Americas,2015,6,7,6,19,12,6,7,10,35,54
Niger,Africa,2015,9,10,7,26,11,8,5,6,30,56
Nigeria,Africa,2015,6,10,4,18,9,7,4,5,25,43
North Korea,Asia,2015,0,0,0,0,0,0,0,3,3,3
North Macedonia,Europe,2015,7,10,6,23,11,8,8,10,37,60
Norway,Europe,2015,12,16,12,40,16,12,16,16,60,100
Oman,Middle East,2015,2,2,2,9,5,3,4,5,17,26
Pakistan,Asia,2015,7,8,5,20,5,7,4,6,22,42
Palau,Asia,2015,12,15,10,37,16,11,15,13,55,92
Panama,Americas,2015,12,15,8,35,15,11,9,12,47,82
Papua New Guinea,Asia,2015,9,10,4,23,12,9,7,8,36,59
Paraguay,Americas,2015,10,12,5,27,12,8,7,11,38,65
Peru,Americas,2015,10,13,7,30,15,8,8,10,41,71
Philippines,Asia,2015,9,10,7,26,14,8,5,10,37,63
Poland,Europe,2015,12,16,10,38,16,12,13,14,55,93
Portugal,Europe,2015,12,16,11,39,16,12,15,15,58,97
Qatar,Middle East,2015,2,2,3,10,8,2,4,4,18,28
Romania,Europe,2015,11,14,9,34,14,11,12,12,49,83
Russia,Eurasia,2015,1,3,3,7,4,4,2,6,16,23
Rwanda,Africa,2015,2,2,5,9,4,2,3,7,16,25
Samoa,Asia,2015,9,13,10,32,14,10,13,12,49,81
San Marino,Europe,2015,12,16,12,40,16,12,16,16,60,100
Sao Tome and Principe,Africa,2015,11,14,9,34,15,10,12,10,47,81
Saudi Arabia,Middle East,2015,0,0,1,3,3,0,2,2,7,10
Senegal,Africa,2015,11,13,9,33,15,10,10,10,45,78
Serbia,Europe,2015,10,14,7,31,15,11,10,13,49,80
Seychelles,Africa,2015,8,10,7,25,11,9,11,11,42,67
Sierra Leone,Africa,2015,10,11,7,28,12,7,9,9,37,65
Singapore,Asia,2015,4,8,7,19,9,4,7,12,32,51
Slovakia,Europe,2015,12,15,10,37,15,12,12,14,53,90
Slovenia,Europe,2015,12,15,11,38,14,12,14,13,53,91
Solomon Islands,Asia,2015,9,10,6,25,14,9,8,12,43,68
Somalia,Africa,2015,0,0,0,0,1,0,0,1,2,2
South Africa,Africa,2015,12,13,8,33,15,12,10,11,48,81
South Korea,Asia,2015,11,13,10,34,13,11,13,13,50,84
South Sudan,Africa,2015,3,2,1,2,4,3,1,5,13,15
Spain,Europe,2015,12,16,11,39,15,12,15,15,57,96
Sri Lanka,Asia,2015,6,8,4,16,6,6,5,8,25,41
St. Kitts and Nevis,Americas,2015,12,16,9,37,15,12,13,13,53,90
St. Lucia,Americas,2015,12,16,11,39,15,12,12,14,53,92
St. Vincent and the Grenadines,Americas,2015,11,16,9,36,15,12,13,14,54,90
Sudan,Africa,2015,2,7,1,2,2,1,0,1,4,6
Suriname,Americas,2015,12,13,8,33,15,11,8,10,44,77
Sweden,Europe,2015,12,16,12,40,15,12,16,16,59,99
Switzerland,Europe,2015,12,15,12,39,15,12,15,15,57,96
Syria,Middle East,2015,0,3,0,-3,2,0,0,0,2,-1
Taiwan,Asia,2015,12,15,10,37,14,10,14,13,51,88
Tajikistan,Eurasia,2015,2,3,2,7,5,3,3,4,15,22
Tanzania,Africa,2015,9,12,7,28,10,7,9,9,35,63
Thailand,Asia,2015,1,4,3,8,6,4,5,10,25,33
The Gambia,Africa,2015,2,5,0,7,3,3,1,6,13,20
Timor-Leste,Asia,2015,11,12,6,29,12,8,7,9,36,65
Togo,Africa,2015,5,8,5,18,9,6,7,7,29,47
Tonga,Asia,2015,11,14,6,31,13,8,11,12,44,75
Trinidad and Tobago,Americas,2015,11,13,9,33,15,11,9,13,48,81
Tunisia,Africa,2015,12,16,8,36,13,10,9,11,43,79
Turkey,Europe,2015,10,10,6,26,8,5,7,9,29,55
Turkmenistan,Eurasia,2015,0,1,0,1,2,0,0,3,5,6
Tuvalu,Asia,2015,12,15,10,37,16,12,15,14,57,94
Uganda,Africa,2015,3,5,3,11,9,4,5,7,25,36
Ukraine,Eurasia,2015,9,10,6,25,11,9,6,11,37,62
United Arab Emirates,Middle East,2015,1,2,2,8,4,2,3,4,13,21
United Kingdom,Europe,2015,12,16,12,40,15,12,15,15,57,97
United States,Americas,2015,11,16,10,37,15,11,14,15,55,92
Uruguay,Americas,2015,12,16,12,40,16,12,15,15,58,98
Uzbekistan,Eurasia,2015,0,0,0,0,1,0,0,3,4,4
Vanuatu,Asia,2015,9,15,8,32,15,11,10,11,47,79
Venezuela,Americas,2015,5,6,2,13,8,3,3,8,22,35
Vietnam,Asia,2015,0,1,2,3,4,1,4,8,17,20
Yemen,Middle East,2015,3,4,2,9,6,3,2,5,16,25
Zambia,Africa,2015,8,12,6,26,11,7,8,8,34,60
Zimbabwe,Africa,2015,3,6,3,12,6,3,2,5,16,28
Afghanistan,Asia,2014,3,6,2,11,6,4,2,3,15,26
Albania,Europe,2014,8,13,6,27,13,9,9,9,40,67
Algeria,Africa,2014,4,4,3,11,6,5,5,7,23,34
Andorra,Europe,2014,12,15,12,39,16,11,15,15,57,96
Angola,Africa,2014,4,6,1,11,7,4,4,3,18,29
Antigua and Barbuda,Americas,2014,11,13,7,31,14,9,13,13,49,80
Argentina,Americas,2014,11,14,6,31,14,11,11,13,49,80
Armenia,Eurasia,2014,5,6,3,14,8,6,6,9,29,43
Australia,Asia,2014,12,15,12,39,16,12,15,15,58,97
Austria,Europe,2014,12,15,11,38,16,12,15,15,58,96
Azerbaijan,Eurasia,2014,1,3,2,6,4,2,4,6,16,22
Bahamas,Americas,2014,12,16,10,38,16,12,15,15,58,96
Bahrain,Middle East,2014,3,4,3,6,2,1,1,6,10,16
Bangladesh,Asia,2014,9,10,5,24,8,6,6,9,29,53
Barbados,Americas,2014,12,16,12,40,16,12,16,15,59,99
Belarus,Eurasia,2014,0,3,1,4,3,1,1,5,10,14
Belgium,Europe,2014,12,16,12,40,15,12,15,15,57,97
Belize,Americas,2014,12,14,10,36,15,11,12,13,51,87
Benin,Africa,2014,8,16,8,32,15,11,12,10,48,80
Bhutan,Asia,2014,10,11,9,28,9,4,6,8,27,55
Bolivia,Americas,2014,11,11,7,29,14,9,6,9,38,67
Bosnia and Herzegovina,Europe,2014,8,10,6,24,10,7,10,10,37,61
Botswana,Africa,2014,10,10,8,28,13,10,12,11,46,74
Brazil,Americas,2014,11,14,8,33,15,10,10,13,48,81
Brunei,Asia,2014,0,3,3,7,6,3,6,8,23,30
Bulgaria,Europe,2014,10,14,7,31,14,11,11,11,47,78
Burkina Faso,Africa,2014,5,8,4,17,13,8,7,8,36,53
Burundi,Africa,2014,4,6,2,12,8,4,4,6,22,34
Cabo Verde,Africa,2014,12,15,10,37,15,11,14,13,53,90
Cambodia,Asia,2014,3,4,3,10,9,3,2,6,20,30
Cameroon,Africa,2014,3,3,2,8,7,3,2,4,16,24
Canada,Americas,2014,12,16,11,39,16,12,15,16,59,98
Central African Republic,Africa,2014,0,2,0,0,4,1,0,1,6,6
Chad,Africa,2014,3,1,1,5,7,4,2,3,16,21
Chile,Americas,2014,12,15,12,39,16,11,14,15,56,95
China,Asia,2014,0,2,2,2,4,3,2,6,15,17
Colombia,Americas,2014,10,11,7,28,12,5,7,10,34,62
Comoros,Africa,2014,9,11,5,25,10,6,8,6,30,55
Congo (Brazzaville),Africa,2014,1,3,3,7,8,6,2,7,23,30
Congo (Kinshasa),Africa,2014,3,4,2,9,7,3,0,1,11,20
Costa Rica,Americas,2014,12,15,10,37,16,11,13,13,53,90
"Cote d'Ivoire",Africa,2014,6,7,4,17,10,7,5,6,28,45
Croatia,Europe,2014,12,15,9,36,14,12,11,13,50,86
Cuba,Americas,2014,0,0,1,1,3,0,2,6,11,12
Cyprus,Europe,2014,11,16,10,37,15,11,15,14,55,92
Czech Republic,Europe,2014,12,15,10,37,16,12,14,15,57,94
Denmark,Europe,2014,12,16,12,40,16,12,15,15,58,98
Djibouti,Africa,2014,3,3,3,9,7,3,4,6,20,29
Dominica,Americas,2014,12,16,10,38,15,12,15,15,57,95
Dominican Republic,Americas,2014,10,11,9,30,15,10,8,10,43,73
Ecuador,Americas,2014,7,11,6,24,13,7,6,10,36,60
Egypt,Africa,2014,1,6,2,9,6,4,4,8,22,31
El Salvador,Americas,2014,12,14,9,35,15,8,9,10,42,77
Equatorial Guinea,Africa,2014,0,1,0,1,4,0,0,3,7,8
Eritrea,Africa,2014,0,0,1,1,0,0,0,2,2,3
Estonia,Europe,2014,12,15,12,39,16,12,14,14,56,95
Eswatini,Africa,2014,0,1,0,1,8,2,5,4,19,20
Ethiopia,Africa,2014,1,2,4,7,3,0,3,5,11,18
Fiji,Asia,2014,0,5,2,7,11,3,6,10,30,37
Finland,Europe,2014,12,16,12,40,16,12,16,16,60,100
France,Europe,2014,12,15,11,38,15,12,15,15,57,95
Gabon,Africa,2014,2,4,3,9,10,4,6,5,25,34
Georgia,Eurasia,2014,8,10,7,25,12,8,8,10,38,63
Germany,Europe,2014,12,15,12,39,15,12,15,15,57,96
Ghana,Africa,2014,12,15,10,37,14,11,12,10,47,84
Greece,Europe,2014,12,15,8,35,14,11,10,13,48,83
Grenada,Americas,2014,12,16,10,38,15,11,12,13,51,89
Guatemala,Americas,2014,9,10,5,24,12,6,6,8,32,56
Guinea,Africa,2014,6,8,3,17,9,6,4,5,24,41
Guinea-Bissau,Africa,2014,3,5,1,9,10,5,3,5,23,32
Guyana,Americas,2014,11,13,7,31,15,10,7,9,41,72
Haiti,Americas,2014,4,9,5,18,10,5,4,6,25,43
Honduras,Americas,2014,7,9,4,20,11,6,5,9,31,51
Hungary,Europe,2014,12,15,9,36,15,12,11,14,52,88
Iceland,Europe,2014,12,16,12,40,16,12,16,16,60,100
India,Asia,2014,11,14,9,34,13,11,9,10,43,77
Indonesia,Asia,2014,11,13,6,30,12,8,5,9,34,64
Iran,Middle East,2014,3,2,2,7,2,1,3,4,10,17
Iraq,Middle East,2014,7,6,1,12,5,4,0,4,13,25
Ireland,Europe,2014,12,16,11,39,16,12,15,15,58,97
Israel,Middle East,2014,12,14,10,36,12,11,11,11,45,81
Italy,Europe,2014,12,15,10,37,15,12,12,14,53,90
Jamaica,Americas,2014,12,13,9,34,15,9,6,10,40,74
Japan,Asia,2014,12,15,10,37,14,11,15,13,53,90
Jordan,Middle East,2014,2,6,3,11,7,3,6,8,24,35
Kazakhstan,Eurasia,2014,2,3,1,6,4,3,4,8,19,25
Kenya,Africa,2014,7,10,5,22,11,7,6,7,31,53
Kiribati,Asia,2014,12,16,8,36,15,12,15,13,55,91
Kosovo,Europe,2014,6,10,3,17,8,6,5,7,26,43
Kuwait,Middle East,2014,2,9,5,16,6,4,7,6,23,39
Kyrgyzstan,Eurasia,2014,6,8,4,14,9,5,4,7,25,39
Laos,Asia,2014,0,0,1,1,4,0,2,5,11,12
Latvia,Europe,2014,12,14,7,33,15,12,12,12,51,84
Lebanon,Middle East,2014,4,9,3,16,11,7,5,9,32,48
Lesotho,Africa,2014,10,13,8,31,14,7,11,9,41,72
Liberia,Africa,2014,9,11,6,26,10,8,7,8,33,59
Libya,Africa,2014,9,9,3,21,8,5,1,6,20,41
Liechtenstein,Europe,2014,12,15,12,39,16,12,15,16,59,98
Lithuania,Europe,2014,12,16,9,37,16,11,13,13,53,90
Luxembourg,Europe,2014,12,16,11,39,16,12,16,16,60,99
Madagascar,Africa,2014,6,8,1,15,9,7,5,7,28,43
Malawi,Africa,2014,8,11,7,26,11,7,9,7,34,60
Malaysia,Asia,2014,6,7,6,19,8,6,5,9,28,47
Maldives,Asia,2014,7,7,5,19,7,7,7,8,29,48
Mali,Africa,2014,6,7,4,17,11,6,6,4,27,44
Malta,Europe,2014,12,16,11,39,16,12,15,15,58,97
Marshall Islands,Asia,2014,11,15,10,36,16,11,15,13,55,91
Mauritania,Africa,2014,3,3,5,11,10,4,4,5,23,34
Mauritius,Africa,2014,12,15,11,38,15,12,13,12,52,90
Mexico,Americas,2014,9,12,7,28,13,8,6,10,37,65
Micronesia,Asia,2014,12,15,10,37,16,11,15,14,56,93
Moldova,Eurasia,2014,11,12,6,29,11,8,7,9,35,64
Monaco,Europe,2014,10,11,10,31,16,12,15,14,57,88
Mongolia,Asia,2014,11,16,9,36,15,11,12,12,50,86
Montenegro,Europe,2014,9,11,7,27,13,10,10,12,45,72
Morocco,Africa,2014,5,7,3,15,8,6,6,7,27,42
Mozambique,Africa,2014,6,10,7,23,12,7,7,9,35,58
Myanmar,Asia,2014,3,9,3,9,7,4,1,5,17,26
Namibia,Africa,2014,10,11,9,30,14,12,11,9,46,76
Nauru,Asia,2014,12,16,10,38,15,11,14,14,54,92
Nepal,Asia,2014,8,11,4,23,9,6,5,7,27,50
Netherlands,Europe,2014,12,16,12,40,16,12,15,16,59,99
New Zealand,Asia,2014,12,15,12,39,16,12,15,15,58,97
Nicaragua,Americas,2014,6,7,6,19,12,6,7,10,35,54
Niger,Africa,2014,9,10,7,26,11,8,5,6,30,56
Nigeria,Africa,2014,6,9,5,20,9,7,4,6,26,46
North Korea,Asia,2014,0,0,0,0,0,0,0,3,3,3
North Macedonia,Europe,2014,8,11,7,26,11,8,8,11,38,64
Norway,Europe,2014,12,16,12,40,16,12,16,16,60,100
Oman,Middle East,2014,2,2,2,9,5,3,4,5,17,26
Pakistan,Asia,2014,7,9,5,21,5,6,4,6,21,42
Palau,Asia,2014,12,15,10,37,16,11,15,13,55,92
Panama,Americas,2014,12,15,8,35,15,11,9,12,47,82
Papua New Guinea,Asia,2014,9,10,5,24,12,9,7,8,36,60
Paraguay,Americas,2014,10,12,4,26,12,8,5,10,35,61
Peru,Americas,2014,10,13,7,30,15,8,8,10,41,71
Philippines,Asia,2014,9,10,7,26,14,8,5,10,37,63
Poland,Europe,2014,12,16,10,38,16,12,13,14,55,93
Portugal,Europe,2014,12,16,11,39,16,12,15,15,58,97
Qatar,Middle East,2014,2,2,3,10,8,2,4,4,18,28
Romania,Europe,2014,12,14,9,35,14,11,12,12,49,84
Russia,Eurasia,2014,1,3,3,7,6,4,2,7,19,26
Rwanda,Africa,2014,2,2,5,9,5,2,3,7,17,26
Samoa,Asia,2014,9,13,10,32,14,10,13,12,49,81
San Marino,Europe,2014,12,16,12,40,16,12,16,16,60,100
Sao Tome and Principe,Africa,2014,11,14,9,34,15,10,12,10,47,81
Saudi Arabia,Middle East,2014,0,0,1,3,3,0,2,2,7,10
Senegal,Africa,2014,11,13,9,33,15,11,10,10,46,79
Serbia,Europe,2014,9,14,7,30,15,10,10,13,48,78
Seychelles,Africa,2014,8,10,7,25,11,9,11,11,42,67
Sierra Leone,Africa,2014,10,12,7,29,12,7,9,10,38,67
Singapore,Asia,2014,4,8,7,19,9,4,7,12,32,51
Slovakia,Europe,2014,12,15,10,37,16,12,12,14,54,91
Slovenia,Europe,2014,12,15,11,38,14,12,14,13,53,91
Solomon Islands,Asia,2014,6,10,6,22,14,9,8,12,43,65
Somalia,Africa,2014,0,0,0,0,1,0,0,1,2,2
South Africa,Africa,2014,12,13,8,33,15,12,10,11,48,81
South Korea,Asia,2014,11,14,10,35,14,11,13,12,50,85
South Sudan,Africa,2014,4,2,2,8,7,3,1,5,16,24
Spain,Europe,2014,12,16,11,39,15,12,15,15,57,96
Sri Lanka,Asia,2014,6,6,4,16,7,6,5,8,26,42
St. Kitts and Nevis,Americas,2014,12,16,9,37,15,12,13,13,53,90
St. Lucia,Americas,2014,12,16,11,39,15,12,12,14,53,92
St. Vincent and the Grenadines,Americas,2014,11,16,9,36,15,12,12,14,53,89
Sudan,Africa,2014,2,7,1,2,3,1,0,1,5,7
Suriname,Americas,2014,12,13,8,33,15,11,8,10,44,77
Sweden,Europe,2014,12,16,12,40,16,12,15,16,59,99
Switzerland,Europe,2014,12,15,12,39,15,12,15,15,57,96
Syria,Middle East,2014,0,2,0,-2,1,0,0,2,3,1
Taiwan,Asia,2014,11,15,10,36,14,11,14,13,52,88
Tajikistan,Eurasia,2014,2,4,2,8,5,4,3,4,16,24
Tanzania,Africa,2014,9,12,8,29,10,7,9,9,35,64
Thailand,Asia,2014,8,9,5,22,10,6,6,10,32,54
The Gambia,Africa,2014,2,5,0,7,4,3,1,6,14,21
Timor-Leste,Asia,2014,11,12,6,29,12,7,6,9,34,63
Togo,Africa,2014,5,8,5,18,9,6,7,7,29,47
Tonga,Asia,2014,11,14,6,31,13,8,11,12,44,75
Trinidad and Tobago,Americas,2014,11,13,9,33,15,11,9,13,48,81
Tunisia,Africa,2014,9,12,6,27,11,9,6,10,36,63
Turkey,Europe,2014,11,10,7,28,9,6,8,9,32,60
Turkmenistan,Eurasia,2014,0,1,0,1,2,0,1,3,6,7
Tuvalu,Asia,2014,12,15,10,37,16,12,15,14,57,94
Uganda,Africa,2014,3,5,3,11,10,4,5,7,26,37
Ukraine,Eurasia,2014,8,8,4,20,9,8,7,11,35,55
United Arab Emirates,Middle East,2014,1,2,2,8,4,2,3,4,13,21
United Kingdom,Europe,2014,12,16,12,40,15,12,15,15,57,97
United States,Americas,2014,11,16,10,37,15,11,14,15,55,92
Uruguay,Americas,2014,12,16,12,40,16,12,15,15,58,98
Uzbekistan,Eurasia,2014,0,0,0,0,1,0,0,3,4,4
Vanuatu,Asia,2014,9,15,8,32,15,11,10,11,47,79
Venezuela,Americas,2014,5,7,2,14,8,4,4,8,24,38
Vietnam,Asia,2014,0,1,2,3,4,1,4,8,17,20
Yemen,Middle East,2014,3,4,3,10,6,3,2,5,16,26
Zambia,Africa,2014,8,10,7,25,11,7,8,8,34,59
Zimbabwe,Africa,2014,3,6,3,12,6,3,2,5,16,28
Afghanistan,Asia,2013,3,6,2,11,6,5,2,3,16,27
Albania,Europe,2013,8,10,6,24,13,8,9,9,39,63
Algeria,Africa,2013,4,4,3,11,7,5,5,7,24,35
Andorra,Europe,2013,12,15,12,39,16,11,15,15,57,96
Angola,Africa,2013,4,6,1,11,8,4,4,3,19,30
Antigua and Barbuda,Americas,2013,11,13,7,31,14,9,13,13,49,80
Argentina,Americas,2013,11,14,6,31,14,11,11,13,49,80
Armenia,Eurasia,2013,5,5,3,13,8,6,6,9,29,42
Australia,Asia,2013,12,15,12,39,16,12,15,15,58,97
Austria,Europe,2013,12,15,11,38,16,12,15,15,58,96
Azerbaijan,Eurasia,2013,1,3,2,6,4,2,4,7,17,23
Bahamas,Americas,2013,12,16,10,38,16,12,15,15,58,96
Bahrain,Middle East,2013,3,4,3,6,3,2,1,6,12,18
Bangladesh,Asia,2013,9,11,5,25,9,7,6,9,31,56
Barbados,Americas,2013,12,16,12,40,16,12,16,15,59,99
Belarus,Eurasia,2013,0,3,1,4,3,1,1,5,10,14
Belgium,Europe,2013,12,16,12,40,15,12,15,15,57,97
Belize,Americas,2013,12,14,11,37,15,11,12,13,51,88
Benin,Africa,2013,8,16,8,32,15,12,13,10,50,82
Bhutan,Asia,2013,8,9,7,22,8,3,5,8,24,46
Bolivia,Americas,2013,11,11,7,29,14,10,7,9,40,69
Bosnia and Herzegovina,Europe,2013,8,11,6,25,10,7,10,10,37,62
Botswana,Africa,2013,10,10,8,28,13,10,12,11,46,74
Brazil,Americas,2013,11,14,8,33,15,10,10,13,48,81
Brunei,Asia,2013,0,3,3,7,6,3,6,8,23,30
Bulgaria,Europe,2013,11,15,8,34,14,11,11,11,47,81
Burkina Faso,Africa,2013,5,8,4,17,13,8,7,8,36,53
Burundi,Africa,2013,4,6,2,12,8,4,4,6,22,34
Cabo Verde,Africa,2013,12,15,10,37,15,11,14,13,53,90
Cambodia,Asia,2013,3,3,3,9,9,3,2,6,20,29
Cameroon,Africa,2013,2,3,2,7,7,3,2,4,16,23
Canada,Americas,2013,12,16,12,40,16,11,15,16,58,98
Central African Republic,Africa,2013,7,7,2,16,8,4,3,4,19,35
Chad,Africa,2013,3,1,1,5,7,4,2,3,16,21
Chile,Americas,2013,12,15,12,39,16,11,15,15,57,96
China,Asia,2013,0,2,2,2,4,3,2,6,15,17
Colombia,Americas,2013,10,10,7,27,12,5,7,10,34,61
Comoros,Africa,2013,9,11,5,25,10,6,8,6,30,55
Congo (Brazzaville),Africa,2013,1,3,3,7,8,6,2,6,22,29
Congo (Kinshasa),Africa,2013,3,4,2,9,7,3,0,1,11,20
Costa Rica,Americas,2013,12,15,11,38,16,11,13,13,53,91
"Cote d'Ivoire",Africa,2013,5,4,4,13,8,5,4,4,21,34
Croatia,Europe,2013,12,15,9,36,14,12,11,13,50,86
Cuba,Americas,2013,0,0,1,1,2,0,2,6,10,11
Cyprus,Europe,2013,11,16,11,38,15,11,15,14,55,93
Czech Republic,Europe,2013,12,15,11,38,16,12,14,15,57,95
Denmark,Europe,2013,12,16,12,40,16,12,15,15,58,98
Djibouti,Africa,2013,3,3,3,9,7,3,4,6,20,29
Dominica,Americas,2013,12,16,10,38,15,12,15,15,57,95
Dominican Republic,Americas,2013,10,12,9,31,15,10,8,11,44,75
Ecuador,Americas,2013,7,11,6,24,13,7,6,10,36,60
Egypt,Africa,2013,3,10,3,16,8,5,4,8,25,41
El Salvador,Americas,2013,12,14,9,35,15,8,9,10,42,77
Equatorial Guinea,Africa,2013,0,1,0,1,4,0,0,3,7,8
Eritrea,Africa,2013,0,0,1,1,0,0,0,2,2,3
Estonia,Europe,2013,12,15,12,39,16,12,14,14,56,95
Eswatini,Africa,2013,0,1,0,1,8,3,5,4,20,21
Ethiopia,Africa,2013,1,2,4,7,3,0,3,5,11,18
Fiji,Asia,2013,0,5,2,7,11,3,6,10,30,37
Finland,Europe,2013,12,16,12,40,16,12,16,16,60,100
France,Europe,2013,12,15,11,38,15,12,15,15,57,95
Gabon,Africa,2013,2,4,3,9,10,4,6,5,25,34
Georgia,Eurasia,2013,7,10,7,24,12,7,7,10,36,60
Germany,Europe,2013,12,15,12,39,15,12,15,15,57,96
Ghana,Africa,2013,12,15,10,37,14,11,12,10,47,84
Greece,Europe,2013,12,15,8,35,14,11,10,13,48,83
Grenada,Americas,2013,12,16,10,38,15,11,12,13,51,89
Guatemala,Americas,2013,9,10,5,24,12,7,6,8,33,57
Guinea,Africa,2013,5,8,2,15,9,6,4,5,24,39
Guinea-Bissau,Africa,2013,2,5,0,7,10,5,3,5,23,30
Guyana,Americas,2013,11,13,7,31,15,9,7,9,40,71
Haiti,Americas,2013,5,9,5,19,10,5,4,5,24,43
Honduras,Americas,2013,6,8,4,18,11,6,7,9,33,51
Hungary,Europe,2013,12,15,9,36,15,12,11,14,52,88
Iceland,Europe,2013,12,16,12,40,16,12,16,16,60,100
India,Asia,2013,11,14,9,34,13,11,8,10,42,76
Indonesia,Asia,2013,11,13,6,30,12,9,5,9,35,65
Iran,Middle East,2013,2,2,2,6,2,1,3,4,10,16
Iraq,Middle East,2013,7,5,1,11,5,4,0,4,13,24
Ireland,Europe,2013,12,16,11,39,16,12,15,15,58,97
Israel,Middle East,2013,12,14,10,36,12,11,11,11,45,81
Italy,Europe,2013,11,15,9,35,15,12,12,14,53,88
Jamaica,Americas,2013,12,13,8,33,15,9,6,10,40,73
Japan,Asia,2013,12,15,10,37,13,10,15,13,51,88
Jordan,Middle East,2013,2,5,3,10,7,3,6,8,24,34
Kazakhstan,Eurasia,2013,2,3,1,6,5,3,4,8,20,26
Kenya,Africa,2013,6,10,5,21,13,8,6,7,34,55
Kiribati,Asia,2013,12,16,8,36,15,12,15,13,55,91
Kosovo,Europe,2013,6,9,3,16,8,6,5,7,26,42
Kuwait,Middle East,2013,2,10,5,17,7,4,7,6,24,41
Kyrgyzstan,Eurasia,2013,6,8,4,14,9,5,4,7,25,39
Laos,Asia,2013,0,0,0,0,4,0,2,5,11,11
Latvia,Europe,2013,12,14,7,33,15,12,12,12,51,84
Lebanon,Middle East,2013,5,9,3,17,11,7,5,9,32,49
Lesotho,Africa,2013,10,13,8,31,14,7,11,9,41,72
Liberia,Africa,2013,9,11,6,26,11,8,7,8,34,60
Libya,Africa,2013,9,10,3,22,8,6,1,6,21,43
Liechtenstein,Europe,2013,12,15,12,39,16,12,15,16,59,98
Lithuania,Europe,2013,12,16,9,37,16,11,13,13,53,90
Luxembourg,Europe,2013,12,16,12,40,16,12,16,16,60,100
Madagascar,Africa,2013,1,5,1,7,9,7,5,7,28,35
Malawi,Africa,2013,8,11,7,26,11,7,9,7,34,60
Malaysia,Asia,2013,6,8,6,20,9,5,5,9,28,48
Maldives,Asia,2013,7,6,4,17,7,7,7,8,29,46
Mali,Africa,2013,1,4,2,5,8,4,3,4,19,24
Malta,Europe,2013,12,16,11,39,16,12,15,15,58,97
Marshall Islands,Asia,2013,11,15,10,36,16,11,15,13,55,91
Mauritania,Africa,2013,3,3,5,11,10,4,4,5,23,34
Mauritius,Africa,2013,12,15,11,38,15,12,13,12,52,90
Mexico,Americas,2013,9,12,7,28,13,8,6,10,37,65
Micronesia,Asia,2013,12,15,10,37,16,11,15,14,56,93
Moldova,Eurasia,2013,11,12,6,29,11,8,8,9,36,65
Monaco,Europe,2013,10,11,10,31,15,12,15,14,56,87
Mongolia,Asia,2013,11,16,9,36,15,11,12,12,50,86
Montenegro,Europe,2013,9,11,7,27,13,10,10,12,45,72
Morocco,Africa,2013,5,7,4,16,8,6,6,7,27,43
Mozambique,Africa,2013,6,10,7,23,12,7,8,9,36,59
Myanmar,Asia,2013,3,9,3,9,7,4,1,5,17,26
Namibia,Africa,2013,10,11,9,30,14,12,11,9,46,76
Nauru,Asia,2013,12,16,10,38,15,11,15,14,55,93
Nepal,Asia,2013,5,11,4,20,9,6,5,7,27,47
Netherlands,Europe,2013,12,16,12,40,16,12,15,16,59,99
New Zealand,Asia,2013,12,15,12,39,16,12,15,15,58,97
Nicaragua,Americas,2013,6,7,4,17,12,6,7,9,34,51
Niger,Africa,2013,9,10,7,26,11,8,5,6,30,56
Nigeria,Africa,2013,6,9,5,20,9,7,4,6,26,46
North Korea,Asia,2013,0,0,0,0,0,0,0,3,3,3
North Macedonia,Europe,2013,8,11,7,26,11,8,8,11,38,64
Norway,Europe,2013,12,16,12,40,16,12,16,16,60,100
Oman,Middle East,2013,2,2,2,9,5,3,4,5,17,26
Pakistan,Asia,2013,6,9,5,20,5,7,4,6,22,42
Palau,Asia,2013,12,15,10,37,16,11,15,13,55,92
Panama,Americas,2013,12,15,9,36,15,10,9,12,46,82
Papua New Guinea,Asia,2013,9,10,4,23,12,9,7,8,36,59
Paraguay,Americas,2013,10,12,5,27,11,8,6,10,35,62
Peru,Americas,2013,10,13,7,30,15,8,8,10,41,71
Philippines,Asia,2013,9,10,7,26,14,8,5,10,37,63
Poland,Europe,2013,12,16,10,38,16,12,13,14,55,93
Portugal,Europe,2013,12,16,11,39,16,12,15,15,58,97
Qatar,Middle East,2013,2,2,3,10,8,2,4,4,18,28
Romania,Europe,2013,10,14,8,32,14,11,12,12,49,81
Russia,Eurasia,2013,1,3,3,7,6,4,3,7,20,27
Rwanda,Africa,2013,2,2,4,8,4,2,3,7,16,24
Samoa,Asia,2013,9,13,10,32,14,10,13,12,49,81
San Marino,Europe,2013,12,16,12,40,16,12,16,16,60,100
Sao Tome and Principe,Africa,2013,11,14,9,34,15,10,12,10,47,81
Saudi Arabia,Middle East,2013,0,0,1,3,3,0,2,2,7,10
Senegal,Africa,2013,11,13,8,32,14,10,10,9,43,75
Serbia,Europe,2013,9,14,7,30,15,10,10,13,48,78
Seychelles,Africa,2013,8,10,7,25,11,9,11,11,42,67
Sierra Leone,Africa,2013,10,12,8,30,13,8,9,10,40,70
Singapore,Asia,2013,4,8,7,19,10,4,7,12,33,52
Slovakia,Europe,2013,12,15,10,37,16,12,13,14,55,92
Slovenia,Europe,2013,12,15,11,38,14,12,14,13,53,91
Solomon Islands,Asia,2013,6,10,6,22,14,9,8,12,43,65
Somalia,Africa,2013,0,0,0,0,1,0,0,1,2,2
South Africa,Africa,2013,12,14,8,34,15,11,10,11,47,81
South Korea,Asia,2013,11,15,10,36,14,11,13,12,50,86
South Sudan,Africa,2013,4,5,2,11,8,4,3,5,20,31
Spain,Europe,2013,12,16,11,39,16,12,14,15,57,96
Sri Lanka,Asia,2013,6,6,4,16,8,6,5,8,27,43
St. Kitts and Nevis,Americas,2013,12,16,10,38,15,12,12,14,53,91
St. Lucia,Americas,2013,12,16,11,39,16,12,12,14,54,93
St. Vincent and the Grenadines,Americas,2013,11,16,9,36,15,11,13,14,53,89
Sudan,Africa,2013,2,7,1,2,3,1,0,1,5,7
Suriname,Americas,2013,12,13,8,33,15,11,8,10,44,77
Sweden,Europe,2013,12,16,12,40,16,12,16,16,60,100
Switzerland,Europe,2013,12,15,12,39,15,12,15,15,57,96
Syria,Middle East,2013,0,2,1,-1,2,0,0,4,6,5
Taiwan,Asia,2013,11,15,10,36,14,11,14,13,52,88
Tajikistan,Eurasia,2013,2,4,2,8,5,4,3,4,16,24
Tanzania,Africa,2013,9,12,7,28,11,7,11,9,38,66
Thailand,Asia,2013,8,9,5,22,9,6,6,10,31,53
The Gambia,Africa,2013,2,5,0,7,5,4,1,6,16,23
Timor-Leste,Asia,2013,11,12,6,29,12,7,6,9,34,63
Togo,Africa,2013,4,8,4,16,8,6,6,7,27,43
Tonga,Asia,2013,11,14,4,29,13,8,11,12,44,73
Trinidad and Tobago,Americas,2013,11,13,9,33,15,11,9,13,48,81
Tunisia,Africa,2013,9,12,5,26,10,8,6,9,33,59
Turkey,Europe,2013,11,10,7,28,9,7,7,10,33,61
Turkmenistan,Eurasia,2013,0,1,0,1,2,0,1,3,6,7
Tuvalu,Asia,2013,12,15,10,37,16,12,15,14,57,94
Uganda,Africa,2013,3,6,3,12,11,4,6,7,28,40
Ukraine,Eurasia,2013,8,9,4,21,10,8,7,11,36,57
United Arab Emirates,Middle East,2013,1,2,2,8,4,2,4,4,14,22
United Kingdom,Europe,2013,12,16,12,40,15,12,15,15,57,97
United States,Americas,2013,11,16,10,37,16,11,14,15,56,93
Uruguay,Americas,2013,12,16,11,39,16,12,15,15,58,97
Uzbekistan,Eurasia,2013,0,0,0,0,1,0,0,3,4,4
Vanuatu,Asia,2013,9,15,8,32,15,11,10,11,47,79
Venezuela,Americas,2013,5,8,2,15,9,4,4,7,24,39
Vietnam,Asia,2013,0,1,1,2,4,1,4,8,17,19
Yemen,Middle East,2013,3,4,2,9,6,3,2,5,16,25
Zambia,Africa,2013,9,12,7,28,11,7,8,8,34,62
Zimbabwe,Africa,2013,3,5,3,11,6,3,1,4,14,25
